"filename", "language", "C++", "Python", "Makefile", "Properties", "comment", "blank", "total"
"/home/unlv/Desktop/rsa306b_api_applications/stored_program/BUILD/Makefile", "Makefile", 0, 0, -210, 0, -48, -27, -285
"/home/unlv/Desktop/rsa306b_api_applications/stored_program/BUILD/test.py", "Python", 0, -10, 0, 0, -5, -15, -30
"/home/unlv/Desktop/rsa306b_api_applications/stored_program/DOC/from_tektronix/cyusb.conf", "Properties", 0, 0, 0, -17, -14, -7, -38
"/home/unlv/Desktop/rsa306b_api_applications/stored_program/RUN/dev/api_experiments/AUDIO_GetVolume.cpp", "C++", -19, 0, 0, 0, -6, -9, -34
"/home/unlv/Desktop/rsa306b_api_applications/stored_program/RUN/dev/api_experiments/Makefile", "Makefile", 0, 0, -17, 0, -2, -6, -25
"/home/unlv/Desktop/rsa306b_api_applications/stored_program/RUN/dev/api_experiments/juice.h", "C++", -9, 0, 0, 0, -4, -10, -23
"/home/unlv/Desktop/rsa306b_api_applications/stored_program/RUN/dev/api_experiments/main.cpp", "C++", -12, 0, 0, 0, -5, -7, -24
"/home/unlv/Desktop/rsa306b_api_applications/stored_program/RUN/dev/computer_vision/compv.py", "Python", 0, -15, 0, 0, -14, -11, -40
"/home/unlv/Desktop/rsa306b_api_applications/stored_program/RUN/dev/graphing/test.py", "Python", 0, -113, 0, 0, -15, -33, -161
"/home/unlv/Desktop/rsa306b_api_applications/stored_program/RUN/dev/integrated_test_v1/plot_spectrum.py", "Python", 0, -23, 0, 0, -93, -34, -150
"/home/unlv/Desktop/rsa306b_api_applications/stored_program/RUN/dev/integrated_test_v1/test_v1.py", "Python", 0, -121, 0, 0, -17, -35, -173
"/home/unlv/Desktop/rsa306b_api_applications/stored_program/RUN/dev/try_binders/dummy.py", "Python", 0, -41, 0, 0, -15, -20, -76
"/home/unlv/Desktop/rsa306b_api_applications/stored_program/RUN/rsagui.py", "Python", 0, -13, 0, 0, -15, -23, -51
"/home/unlv/Desktop/rsa306b_api_applications/stored_program/RUN/top.py", "Python", 0, -4, 0, 0, -15, -21, -40
"/home/unlv/Desktop/rsa306b_api_applications/stored_program/SRC/rsa_cpp/program_core/common_utility/common_utility.h", "C++", 168, 0, 0, 0, 37, 3, 208
"/home/unlv/Desktop/rsa306b_api_applications/stored_program/SRC/rsa_cpp/program_core/common_utility/cu_batch_decode.cpp", "C++", 125, 0, 0, 0, 33, 17, 175
"/home/unlv/Desktop/rsa306b_api_applications/stored_program/SRC/rsa_cpp/program_core/common_utility/cu_common_utility.cpp", "C++", 2, 0, 0, 0, 0, 0, 2
"/home/unlv/Desktop/rsa306b_api_applications/stored_program/SRC/rsa_cpp/program_core/common_utility/cu_decode.cpp", "C++", 238, 0, 0, 0, 28, 36, 302
"/home/unlv/Desktop/rsa306b_api_applications/stored_program/SRC/rsa_cpp/program_core/common_utility/cu_exe_1.cpp", "C++", 69, 0, 0, 0, 17, 21, 107
"/home/unlv/Desktop/rsa306b_api_applications/stored_program/SRC/rsa_cpp/program_core/common_utility/cu_file_modification.cpp", "C++", 250, 0, 0, 0, 87, 54, 391
"/home/unlv/Desktop/rsa306b_api_applications/stored_program/SRC/rsa_cpp/program_core/common_utility/cu_find_file_info.cpp", "C++", 375, 0, 0, 0, 76, 64, 515
"/home/unlv/Desktop/rsa306b_api_applications/stored_program/SRC/rsa_cpp/program_core/common_utility/cu_help_1.cpp", "C++", -89, 0, 0, 0, -20, -16, -125
"/home/unlv/Desktop/rsa306b_api_applications/stored_program/SRC/rsa_cpp/program_core/common_utility/cu_help_decode.cpp", "C++", -238, 0, 0, 0, -23, -35, -296
"/home/unlv/Desktop/rsa306b_api_applications/stored_program/SRC/rsa_cpp/program_core/common_utility/cu_make_date_timestamp.cpp", "C++", -34, 0, 0, 0, -17, -13, -64
"/home/unlv/Desktop/rsa306b_api_applications/stored_program/SRC/rsa_cpp/program_core/common_utility/cu_timing.cpp", "C++", 47, 0, 0, 0, 14, 12, 73
"/home/unlv/Desktop/rsa306b_api_applications/stored_program/SRC/rsa_cpp/program_core/common_utility/cu_wchar_2_char.cpp", "C++", -5, 0, 0, 0, 8, 5, 8
"/home/unlv/Desktop/rsa306b_api_applications/stored_program/SRC/rsa_cpp/program_core/control/codez.h", "C++", 8, 0, 0, 0, 0, 0, 8
"/home/unlv/Desktop/rsa306b_api_applications/stored_program/SRC/rsa_cpp/program_core/control/common_libraries.h", "C++", 3, 0, 0, 0, 0, 0, 3
"/home/unlv/Desktop/rsa306b_api_applications/stored_program/SRC/rsa_cpp/program_core/control/constant_expersions.h", "C++", 136, 0, 0, 0, 11, 12, 159
"/home/unlv/Desktop/rsa306b_api_applications/stored_program/SRC/rsa_cpp/program_core/control/de_bug/debug_functions.cpp", "C++", 7, 0, 0, 0, 0, 0, 7
"/home/unlv/Desktop/rsa306b_api_applications/stored_program/SRC/rsa_cpp/program_core/control/resourcez.h", "C++", -2, 0, 0, 0, -2, -2, -6
"/home/unlv/Desktop/rsa306b_api_applications/stored_program/SRC/rsa_cpp/program_core/main.cpp", "C++", 65, 0, 0, 0, 5, 9, 79
"/home/unlv/Desktop/rsa306b_api_applications/stored_program/SRC/rsa_cpp/program_core/r3f_manager/r3f_batch_process_files.cpp", "C++", 152, 0, 0, 0, 26, 16, 194
"/home/unlv/Desktop/rsa306b_api_applications/stored_program/SRC/rsa_cpp/program_core/r3f_manager/r3f_copy_vars.cpp", "C++", 81, 0, 0, 0, 20, 16, 117
"/home/unlv/Desktop/rsa306b_api_applications/stored_program/SRC/rsa_cpp/program_core/r3f_manager/r3f_init.cpp", "C++", 96, 0, 0, 0, 16, 20, 132
"/home/unlv/Desktop/rsa306b_api_applications/stored_program/SRC/rsa_cpp/program_core/r3f_manager/r3f_load_file.cpp", "C++", 113, 0, 0, 0, 38, 14, 165
"/home/unlv/Desktop/rsa306b_api_applications/stored_program/SRC/rsa_cpp/program_core/r3f_manager/r3f_manager.cpp", "C++", 30, 0, 0, 0, 26, 17, 73
"/home/unlv/Desktop/rsa306b_api_applications/stored_program/SRC/rsa_cpp/program_core/r3f_manager/r3f_manager_class.h", "C++", 10, 0, 0, 0, -92, -8, -90
"/home/unlv/Desktop/rsa306b_api_applications/stored_program/SRC/rsa_cpp/program_core/r3f_manager/r3f_manager_struct.h", "C++", -17, 0, 0, 0, -1, 0, -18
"/home/unlv/Desktop/rsa306b_api_applications/stored_program/SRC/rsa_cpp/program_core/r3f_manager/r3f_populate_data.cpp", "C++", 97, 0, 0, 0, 18, 17, 132
"/home/unlv/Desktop/rsa306b_api_applications/stored_program/SRC/rsa_cpp/program_core/r3f_manager/r3f_populate_header.cpp", "C++", 452, 0, 0, 0, 68, 49, 569
"/home/unlv/Desktop/rsa306b_api_applications/stored_program/SRC/rsa_cpp/program_core/r3f_manager/r3f_write_csv.cpp", "C++", 59, 0, 0, 0, 24, 18, 101
"/home/unlv/Desktop/rsa306b_api_applications/stored_program/SRC/rsa_cpp/program_core/r3f_manager/r3fc_file_decode.cpp", "C++", -1, 0, 0, 0, -111, -10, -122
"/home/unlv/Desktop/rsa306b_api_applications/stored_program/SRC/rsa_cpp/program_core/r3f_manager/r3fc_file_process.cpp", "C++", 0, 0, 0, 0, -552, -45, -597
"/home/unlv/Desktop/rsa306b_api_applications/stored_program/SRC/rsa_cpp/program_core/r3f_manager/r3fc_handle_adc.cpp", "C++", 0, 0, 0, 0, -322, -34, -356
"/home/unlv/Desktop/rsa306b_api_applications/stored_program/SRC/rsa_cpp/program_core/r3f_manager/r3fc_plot_maker.cpp", "C++", 0, 0, 0, 0, -217, -24, -241
"/home/unlv/Desktop/rsa306b_api_applications/stored_program/SRC/rsa_cpp/program_core/r3f_manager/r3fc_private.cpp", "C++", 0, 0, 0, 0, -212, -30, -242
"/home/unlv/Desktop/rsa306b_api_applications/stored_program/SRC/rsa_cpp/program_core/r3f_manager/r3fc_public.cpp", "C++", -21, 0, 0, 0, -183, -43, -247
"/home/unlv/Desktop/rsa306b_api_applications/stored_program/SRC/rsa_cpp/program_core/rsa306b/rsa306b_ALIGN/rsa306b_align_copy.cpp", "C++", -3, 0, 0, 0, 0, 0, -3
"/home/unlv/Desktop/rsa306b_api_applications/stored_program/SRC/rsa_cpp/program_core/rsa306b/rsa306b_AUDIO/rsa306b_audio_copy.cpp", "C++", -3, 0, 0, 0, 0, 0, -3
"/home/unlv/Desktop/rsa306b_api_applications/stored_program/SRC/rsa_cpp/program_core/rsa306b/rsa306b_CONFIG/rsa306b_config_copy.cpp", "C++", -3, 0, 0, 0, 0, 0, -3
"/home/unlv/Desktop/rsa306b_api_applications/stored_program/SRC/rsa_cpp/program_core/rsa306b/rsa306b_DEVICE/rsa306b_device_copy.cpp", "C++", -3, 0, 0, 0, 0, 0, -3
"/home/unlv/Desktop/rsa306b_api_applications/stored_program/SRC/rsa_cpp/program_core/rsa306b/rsa306b_DEVICE/rsa306b_device_get.cpp", "C++", -4, 0, 0, 0, 4, 0, 0
"/home/unlv/Desktop/rsa306b_api_applications/stored_program/SRC/rsa_cpp/program_core/rsa306b/rsa306b_DEVICE/rsa306b_device_user_checker.cpp", "C++", -4, 0, 0, 0, 4, 0, 0
"/home/unlv/Desktop/rsa306b_api_applications/stored_program/SRC/rsa_cpp/program_core/rsa306b/rsa306b_DEVICE/rsa306b_device_user_operator.cpp", "C++", -5, 0, 0, 0, 1, 0, -4
"/home/unlv/Desktop/rsa306b_api_applications/stored_program/SRC/rsa_cpp/program_core/rsa306b/rsa306b_DPX/rsa306b_dpx_copy.cpp", "C++", 102, 0, 0, 0, 71, 49, 222
"/home/unlv/Desktop/rsa306b_api_applications/stored_program/SRC/rsa_cpp/program_core/rsa306b/rsa306b_DPX/rsa306b_dpx_struct.h", "C++", 3, 0, 0, 0, 76, 4, 83
"/home/unlv/Desktop/rsa306b_api_applications/stored_program/SRC/rsa_cpp/program_core/rsa306b/rsa306b_GP/rsa306b_class.cpp", "C++", -9, 0, 0, 0, 9, 0, 0
"/home/unlv/Desktop/rsa306b_api_applications/stored_program/SRC/rsa_cpp/program_core/rsa306b/rsa306b_GP/rsa306b_gp_print.cpp", "C++", 1, 0, 0, 0, 0, 0, 1
"/home/unlv/Desktop/rsa306b_api_applications/stored_program/SRC/rsa_cpp/program_core/rsa306b/rsa306b_IFSTREAM/rsa306b_ifstream_copy.cpp", "C++", -3, 0, 0, 0, 0, 0, -3
"/home/unlv/Desktop/rsa306b_api_applications/stored_program/SRC/rsa_cpp/program_core/rsa306b/rsa306b_IFSTREAM/rsa306b_ifstream_get.cpp", "C++", -1, 0, 0, 0, 0, 0, -1
"/home/unlv/Desktop/rsa306b_api_applications/stored_program/SRC/rsa_cpp/program_core/rsa306b/rsa306b_IFSTREAM/rsa306b_ifstream_set.cpp", "C++", 1, 0, 0, 0, 0, 1, 2
"/home/unlv/Desktop/rsa306b_api_applications/stored_program/SRC/rsa_cpp/program_core/rsa306b/rsa306b_IFSTREAM/rsa306b_ifstream_user_adc_data.cpp", "C++", -7, 0, 0, 0, 0, -5, -12
"/home/unlv/Desktop/rsa306b_api_applications/stored_program/SRC/rsa_cpp/program_core/rsa306b/rsa306b_IFSTREAM/rsa306b_ifstream_user_framed_adc_data.cpp", "C++", -5, 0, 0, 0, 7, 0, 2
"/home/unlv/Desktop/rsa306b_api_applications/stored_program/SRC/rsa_cpp/program_core/rsa306b/rsa306b_IFSTREAM/rsa306b_ifstream_user_record_r3f.cpp", "C++", 19, 0, 0, 0, 1, 1, 21
"/home/unlv/Desktop/rsa306b_api_applications/stored_program/SRC/rsa_cpp/program_core/rsa306b/rsa306b_IFSTREAM/rsa306b_ifstream_user_write_csv_equalization.cpp", "C++", -9, 0, 0, 0, 0, 0, -9
"/home/unlv/Desktop/rsa306b_api_applications/stored_program/SRC/rsa_cpp/program_core/rsa306b/rsa306b_IQBLK/rsa306b_iqblk_copy.cpp", "C++", -3, 0, 0, 0, 0, 0, -3
"/home/unlv/Desktop/rsa306b_api_applications/stored_program/SRC/rsa_cpp/program_core/rsa306b/rsa306b_IQSTREAM/rsa306b_iqstream_acquire.cpp", "C++", -4, 0, 0, 0, 0, 0, -4
"/home/unlv/Desktop/rsa306b_api_applications/stored_program/SRC/rsa_cpp/program_core/rsa306b/rsa306b_IQSTREAM/rsa306b_iqstream_copy.cpp", "C++", 16, 0, 0, 0, 1, 0, 17
"/home/unlv/Desktop/rsa306b_api_applications/stored_program/SRC/rsa_cpp/program_core/rsa306b/rsa306b_IQSTREAM/rsa306b_iqstream_get.cpp", "C++", -11, 0, 0, 0, 1, 0, -10
"/home/unlv/Desktop/rsa306b_api_applications/stored_program/SRC/rsa_cpp/program_core/rsa306b/rsa306b_IQSTREAM/rsa306b_iqstream_init.cpp", "C++", -1, 0, 0, 0, -1, -2, -4
"/home/unlv/Desktop/rsa306b_api_applications/stored_program/SRC/rsa_cpp/program_core/rsa306b/rsa306b_IQSTREAM/rsa306b_iqstream_set.cpp", "C++", 1, 0, 0, 0, 0, 1, 2
"/home/unlv/Desktop/rsa306b_api_applications/stored_program/SRC/rsa_cpp/program_core/rsa306b/rsa306b_IQSTREAM/rsa306b_iqstream_struct.h", "C++", 0, 0, 0, 0, -1, 0, -1
"/home/unlv/Desktop/rsa306b_api_applications/stored_program/SRC/rsa_cpp/program_core/rsa306b/rsa306b_IQSTREAM/rsa306b_iqstream_user.cpp", "C++", 9, 0, 0, 0, 1, 1, 11
"/home/unlv/Desktop/rsa306b_api_applications/stored_program/SRC/rsa_cpp/program_core/rsa306b/rsa306b_IQSTREAM/rsa306b_iqstream_user_record_siq.cpp", "C++", -10, 0, 0, 0, 50, 2, 42
"/home/unlv/Desktop/rsa306b_api_applications/stored_program/SRC/rsa_cpp/program_core/rsa306b/rsa306b_REFTIME/rsa306b_reftime_copy.cpp", "C++", -3, 0, 0, 0, 0, 0, -3
"/home/unlv/Desktop/rsa306b_api_applications/stored_program/SRC/rsa_cpp/program_core/rsa306b/rsa306b_SPECTRUM/rsa306b_spectrum_copy.cpp", "C++", -3, 0, 0, 0, 0, 0, -3
"/home/unlv/Desktop/rsa306b_api_applications/stored_program/SRC/rsa_cpp/program_core/rsa306b/rsa306b_SPECTRUM/rsa306b_spectrum_helper.cpp", "C++", 1, 0, 0, 0, -1, 0, 0
"/home/unlv/Desktop/rsa306b_api_applications/stored_program/SRC/rsa_cpp/program_core/rsa306b/rsa306b_SPECTRUM/rsa306b_spectrum_scanner.cpp", "C++", -246, 0, 0, 0, -23, -28, -297
"/home/unlv/Desktop/rsa306b_api_applications/stored_program/SRC/rsa_cpp/program_core/rsa306b/rsa306b_SPECTRUM/rsa306b_spectrum_struct.h", "C++", 0, 0, 0, 0, -1, -1, -2
"/home/unlv/Desktop/rsa306b_api_applications/stored_program/SRC/rsa_cpp/program_core/rsa306b/rsa306b_SPECTRUM/rsa306b_spectrum_user.cpp", "C++", -16, 0, 0, 0, 25, -1, 8
"/home/unlv/Desktop/rsa306b_api_applications/stored_program/SRC/rsa_cpp/program_core/rsa306b/rsa306b_TRIG/rsa306b_trig_copy.cpp", "C++", -3, 0, 0, 0, 0, 0, -3
"/home/unlv/Desktop/rsa306b_api_applications/stored_program/SRC/rsa_cpp/program_core/rsa306b/rsa306b_class.h", "C++", 54, 0, 0, 0, 1, 2, 57
"/home/unlv/Desktop/rsa306b_api_applications/stored_program/SRC/rsa_cpp/program_core/rsa306b/rsa306b_constants.h", "C++", 0, 0, 0, 0, -6, -8, -14
"/home/unlv/Desktop/rsa306b_api_applications/stored_program/SRC/rsa_cpp/program_core/rsa306b/rsa306b_special/rsa306b_scan_dump.cpp", "C++", 263, 0, 0, 0, 32, 18, 313
"/home/unlv/Desktop/rsa306b_api_applications/stored_program/SRC/rsa_cpp/program_core/rsa306b/rsa306b_special/rsa306b_spectrum_scanner.cpp", "C++", 246, 0, 0, 0, 23, 28, 297
"/home/unlv/Desktop/rsa306b_api_applications/stored_program/SRC/rsa_cpp/program_core/siq_manager/siq_batch_process_files.cpp", "C++", 120, 0, 0, 0, 24, 15, 159
"/home/unlv/Desktop/rsa306b_api_applications/stored_program/SRC/rsa_cpp/program_core/siq_manager/siq_common.cpp", "C++", -23, 0, 0, 0, -242, -51, -316
"/home/unlv/Desktop/rsa306b_api_applications/stored_program/SRC/rsa_cpp/program_core/siq_manager/siq_copy.cpp", "C++", 111, 0, 0, 0, 17, 32, 160
"/home/unlv/Desktop/rsa306b_api_applications/stored_program/SRC/rsa_cpp/program_core/siq_manager/siq_decode.cpp", "C++", 0, 0, 0, 0, -163, -22, -185
"/home/unlv/Desktop/rsa306b_api_applications/stored_program/SRC/rsa_cpp/program_core/siq_manager/siq_error_codes.cpp", "C++", -1, 0, 0, 0, -75, -16, -92
"/home/unlv/Desktop/rsa306b_api_applications/stored_program/SRC/rsa_cpp/program_core/siq_manager/siq_init.cpp", "C++", 95, 0, 0, 0, 37, 37, 169
"/home/unlv/Desktop/rsa306b_api_applications/stored_program/SRC/rsa_cpp/program_core/siq_manager/siq_init_copy.cpp", "C++", 0, 0, 0, 0, -235, -66, -301
"/home/unlv/Desktop/rsa306b_api_applications/stored_program/SRC/rsa_cpp/program_core/siq_manager/siq_load_file.cpp", "C++", 87, 0, 0, 0, 38, 15, 140
"/home/unlv/Desktop/rsa306b_api_applications/stored_program/SRC/rsa_cpp/program_core/siq_manager/siq_loader.cpp", "C++", 0, 0, 0, 0, -1134, -28, -1162
"/home/unlv/Desktop/rsa306b_api_applications/stored_program/SRC/rsa_cpp/program_core/siq_manager/siq_manager.cpp", "C++", 33, 0, 0, 0, 26, 16, 75
"/home/unlv/Desktop/rsa306b_api_applications/stored_program/SRC/rsa_cpp/program_core/siq_manager/siq_manager_class.h", "C++", 7, 0, 0, 0, -47, -2, -42
"/home/unlv/Desktop/rsa306b_api_applications/stored_program/SRC/rsa_cpp/program_core/siq_manager/siq_manager_struct.h", "C++", -142, 0, 0, 0, -8, -10, -160
"/home/unlv/Desktop/rsa306b_api_applications/stored_program/SRC/rsa_cpp/program_core/siq_manager/siq_populate_data.cpp", "C++", 162, 0, 0, 0, 17, 9, 188
"/home/unlv/Desktop/rsa306b_api_applications/stored_program/SRC/rsa_cpp/program_core/siq_manager/siq_populate_header.cpp", "C++", 897, 0, 0, 0, 44, 11, 952
"/home/unlv/Desktop/rsa306b_api_applications/stored_program/SRC/rsa_cpp/program_core/siq_manager/siq_printer.cpp", "C++", 0, 0, 0, 0, -205, -21, -226
"/home/unlv/Desktop/rsa306b_api_applications/stored_program/SRC/rsa_cpp/program_core/siq_manager/siq_write.cpp", "C++", 214, 0, 0, 0, 31, 57, 302
"/home/unlv/Desktop/rsa306b_api_applications/stored_program/SRC/rsa_cpp/program_core/siq_manager/siq_write_csv.cpp", "C++", 0, 0, 0, 0, -206, -24, -230
"/home/unlv/Desktop/rsa306b_api_applications/stored_program/SRC/rsa_cpp/program_test/tasks/task_998.cpp", "C++", 86, 0, 0, 0, 6, 13, 105
"/home/unlv/Desktop/rsa306b_api_applications/stored_program/SRC/rsa_cpp/program_test/tasks/task_999.cpp", "C++", 15, 0, 0, 0, 15, 2, 32
"/home/unlv/Desktop/rsa306b_api_applications/stored_program/SRC/rsa_cpp/program_test/test_selector.cpp", "C++", 4, 0, 0, 0, 0, 0, 4
"/home/unlv/Desktop/rsa306b_api_applications/stored_program/SRC/rsa_cpp/program_test/testz.h", "C++", 3, 0, 0, 0, -5, 0, -2
"/home/unlv/Desktop/rsa306b_api_applications/stored_program/SRC/rsa_cpp/program_test/units/unit_test_1.cpp", "C++", 185, 0, 0, 0, 58, 21, 264
"/home/unlv/Desktop/rsa306b_api_applications/stored_program/SRC/rsa_cpp/program_test/units/unit_test_11.cpp", "C++", -1, 0, 0, 0, 0, 0, -1
"/home/unlv/Desktop/rsa306b_api_applications/stored_program/SRC/rsa_cpp/program_test/units/unit_test_12.cpp", "C++", 150, 0, 0, 0, 30, 44, 224
"/home/unlv/Desktop/rsa306b_api_applications/stored_program/SRC/rsa_cpp/program_test/units/unit_test_13.cpp", "C++", 189, 0, 0, 0, 21, 51, 261
"/home/unlv/Desktop/rsa306b_api_applications/stored_program/SRC/rsa_cpp/program_test/units/unit_test_14.cpp", "C++", 182, 0, 0, 0, 22, 49, 253
"/home/unlv/Desktop/rsa306b_api_applications/stored_program/SRC/rsa_cpp/python_interface/python_interface.h", "C++", 21, 0, 0, 0, 5, 5, 31
"/home/unlv/Desktop/rsa306b_api_applications/stored_program/SRC/rsa_cpp/python_interface/raw_r3f.cpp", "C++", 114, 0, 0, 0, 10, 18, 142
"/home/unlv/Desktop/rsa306b_api_applications/stored_program/SRC/rsa_cpp/python_interface/raw_siq.cpp", "C++", 60, 0, 0, 0, 8, 14, 82
"/home/unlv/Desktop/rsa306b_api_applications/stored_program/SRC/rsa_cpp/python_interface/rsa_ifstream.cpp", "C++", 81, 0, 0, 0, 18, 18, 117
"/home/unlv/Desktop/rsa306b_api_applications/stored_program/SRC/rsa_cpp/python_interface/rsa_iqstream.cpp", "C++", 67, 0, 0, 0, 16, 25, 108
"/home/unlv/Desktop/rsa306b_api_applications/stored_program/SRC/rsa_cpp/python_interface/rsa_spectrum.cpp", "C++", -28, 0, 0, 0, -2, -1, -31
"/home/unlv/Desktop/rsa306b_api_applications/stored_program/SRC/rsa_cpp/python_interface/special.cpp", "C++", 124, 0, 0, 0, 10, 19, 153
"/home/unlv/Desktop/rsa306b_api_applications/stored_program/SRC/unlv_rsapy/__init__.py", "Python", 0, 31, 0, 0, 0, 0, 31
"/home/unlv/Desktop/rsa306b_api_applications/stored_program/SRC/unlv_rsapy/funz/admin.py", "Python", 0, 62, 0, 0, 0, 8, 70
"/home/unlv/Desktop/rsa306b_api_applications/stored_program/SRC/unlv_rsapy/funz/plot_eq.py", "Python", 0, 35, 0, 0, 9, 8, 52
"/home/unlv/Desktop/rsa306b_api_applications/stored_program/SRC/unlv_rsapy/funz/plot_if.py", "Python", 0, 31, 0, 0, 9, 8, 48
"/home/unlv/Desktop/rsa306b_api_applications/stored_program/SRC/unlv_rsapy/funz/plot_iq.py", "Python", 0, 35, 0, 0, 9, 8, 52
"/home/unlv/Desktop/rsa306b_api_applications/stored_program/SRC/unlv_rsapy/funz/plot_iqblk.py", "Python", 0, -35, 0, 0, -9, -8, -52
"/home/unlv/Desktop/rsa306b_api_applications/stored_program/SRC/unlv_rsapy/r3f_wrapper/f_r3f.py", "Python", 0, 16, 0, 0, 4, 8, 28
"/home/unlv/Desktop/rsa306b_api_applications/stored_program/SRC/unlv_rsapy/r3f_wrapper/r3f_utility.py", "Python", 0, 12, 0, 0, 4, 7, 23
"/home/unlv/Desktop/rsa306b_api_applications/stored_program/SRC/unlv_rsapy/r3f_wrapper/r3fw.py", "Python", 0, -2, 0, 0, -4, -5, -11
"/home/unlv/Desktop/rsa306b_api_applications/stored_program/SRC/unlv_rsapy/rsa_wrapper/api_config.py", "Python", 0, 4, 0, 0, 0, 0, 4
"/home/unlv/Desktop/rsa306b_api_applications/stored_program/SRC/unlv_rsapy/rsa_wrapper/api_ifstream.py", "Python", 0, 25, 0, 0, 5, 10, 40
"/home/unlv/Desktop/rsa306b_api_applications/stored_program/SRC/unlv_rsapy/rsa_wrapper/api_iqblk.py", "Python", 0, 4, 0, 0, 0, 0, 4
"/home/unlv/Desktop/rsa306b_api_applications/stored_program/SRC/unlv_rsapy/rsa_wrapper/api_iqstream.py", "Python", 0, 20, 0, 0, 5, 9, 34
"/home/unlv/Desktop/rsa306b_api_applications/stored_program/SRC/unlv_rsapy/rsa_wrapper/api_spectrum.py", "Python", 0, -9, 0, 0, 0, -1, -10
"/home/unlv/Desktop/rsa306b_api_applications/stored_program/SRC/unlv_rsapy/rsa_wrapper/f_ifstream.py", "Python", 0, 52, 0, 0, 4, 13, 69
"/home/unlv/Desktop/rsa306b_api_applications/stored_program/SRC/unlv_rsapy/rsa_wrapper/f_iqblk.py", "Python", 0, 2, 0, 0, 0, 1, 3
"/home/unlv/Desktop/rsa306b_api_applications/stored_program/SRC/unlv_rsapy/rsa_wrapper/f_iqstream.py", "Python", 0, 37, 0, 0, 4, 9, 50
"/home/unlv/Desktop/rsa306b_api_applications/stored_program/SRC/unlv_rsapy/rsa_wrapper/f_spectrum.py", "Python", 0, 4, 0, 0, 0, 0, 4
"/home/unlv/Desktop/rsa306b_api_applications/stored_program/SRC/unlv_rsapy/siq_wrapper/f_siq.py", "Python", 0, 8, 0, 0, 4, 7, 19
"/home/unlv/Desktop/rsa306b_api_applications/stored_program/SRC/unlv_rsapy/siq_wrapper/siq_utility.py", "Python", 0, 7, 0, 0, 4, 6, 17
"/home/unlv/Desktop/rsa306b_api_applications/stored_program/SRC/unlv_rsapy/siq_wrapper/siqw.py", "Python", 0, -2, 0, 0, -4, -5, -11
"/home/unlv/Desktop/rsa306b_api_applications/stored_program/SRC/unlv_rsapy/special/special.py", "Python", 0, 53, 0, 0, 5, 7, 65
"Total", "-", 5305, 50, -227, -17, -3014, 264, 2361