"filename", "language", "C++", "comment", "blank", "total"
"/home/unlv/Desktop/rsa306b_api_applications/stored_program/SRC/rsa_cpp/program_test/units/unit_test_0.cpp", "C++", 17, 18, 11, 46
"/home/unlv/Desktop/rsa306b_api_applications/stored_program/SRC/rsa_cpp/program_test/units/unit_test_1.cpp", "C++", 251, 71, 62, 384
"/home/unlv/Desktop/rsa306b_api_applications/stored_program/SRC/rsa_cpp/program_test/units/unit_test_10.cpp", "C++", 108, 20, 25, 153
"/home/unlv/Desktop/rsa306b_api_applications/stored_program/SRC/rsa_cpp/program_test/units/unit_test_11.cpp", "C++", 181, 27, 34, 242
"/home/unlv/Desktop/rsa306b_api_applications/stored_program/SRC/rsa_cpp/program_test/units/unit_test_2.cpp", "C++", 69, 23, 28, 120
"/home/unlv/Desktop/rsa306b_api_applications/stored_program/SRC/rsa_cpp/program_test/units/unit_test_3.cpp", "C++", 125, 29, 42, 196
"/home/unlv/Desktop/rsa306b_api_applications/stored_program/SRC/rsa_cpp/program_test/units/unit_test_4.cpp", "C++", 60, 19, 25, 104
"/home/unlv/Desktop/rsa306b_api_applications/stored_program/SRC/rsa_cpp/program_test/units/unit_test_5.cpp", "C++", 59, 18, 26, 103
"/home/unlv/Desktop/rsa306b_api_applications/stored_program/SRC/rsa_cpp/program_test/units/unit_test_6.cpp", "C++", 72, 21, 28, 121
"/home/unlv/Desktop/rsa306b_api_applications/stored_program/SRC/rsa_cpp/program_test/units/unit_test_7.cpp", "C++", 145, 26, 34, 205
"/home/unlv/Desktop/rsa306b_api_applications/stored_program/SRC/rsa_cpp/program_test/units/unit_test_8.cpp", "C++", 58, 39, 29, 126
"/home/unlv/Desktop/rsa306b_api_applications/stored_program/SRC/rsa_cpp/program_test/units/unit_test_9.cpp", "C++", 168, 42, 48, 258
"Total", "-", 1313, 353, 392, 2058