"filename", "language", "C++", "Python", "comment", "blank", "total"
"/home/unlv/Desktop/rsa306b_api_applications/stored_program/SRC/rsa_cpp/program_core/control/constant_expersions.h", "C++", 4, 0, 0, 0, 4
"/home/unlv/Desktop/rsa306b_api_applications/stored_program/SRC/rsa_cpp/program_core/rsa306b/rsa306b_IFSTREAM/rsa306b_ifstream_user_record_r3f.cpp", "C++", -9, 0, 18, 1, 10
"/home/unlv/Desktop/rsa306b_api_applications/stored_program/SRC/rsa_cpp/program_core/rsa306b/rsa306b_IQSTREAM/rsa306b_iqstream_user_record_siq.cpp", "C++", 21, 0, -20, 0, 1
"/home/unlv/Desktop/rsa306b_api_applications/stored_program/SRC/rsa_cpp/program_core/rsa306b/rsa306b_special/rsa306b_scan_dump.cpp", "C++", 12, 0, 0, 1, 13
"/home/unlv/Desktop/rsa306b_api_applications/stored_program/SRC/unlv_rsapy/__init__.py", "Python", 0, 4, 0, 2, 6
"/home/unlv/Desktop/rsa306b_api_applications/stored_program/SRC/unlv_rsapy/configuration.py", "Python", 0, 4, 0, 0, 4
"/home/unlv/Desktop/rsa306b_api_applications/stored_program/SRC/unlv_rsapy/funz/admin.py", "Python", 0, 4, 0, 0, 4
"/home/unlv/Desktop/rsa306b_api_applications/stored_program/SRC/unlv_rsapy/funz/disk_and_file.py", "Python", 0, 52, 2, 1, 55
"/home/unlv/Desktop/rsa306b_api_applications/stored_program/SRC/unlv_rsapy/funz/tester.py", "Python", 0, 64, 9, 9, 82
"/home/unlv/Desktop/rsa306b_api_applications/stored_program/SRC/unlv_rsapy/rsa_wrapper/f_spectrum.py", "Python", 0, 2, 1, 2, 5
"/home/unlv/Desktop/rsa306b_api_applications/stored_program/SRC/unlv_rsapy/special/special.py", "Python", 0, 73, 0, 4, 77
"Total", "-", 28, 203, 10, 20, 261