"filename", "language", "Python", "C++", "Makefile", "comment", "blank", "total"
"/home/unlv/Desktop/rsa306b_api_applications/stored_program/RUN/dev/api_experiments/AUDIO_GetVolume.cpp", "C++", 0, 19, 0, 6, 9, 34
"/home/unlv/Desktop/rsa306b_api_applications/stored_program/RUN/dev/api_experiments/Makefile", "Makefile", 0, 0, 17, 2, 6, 25
"/home/unlv/Desktop/rsa306b_api_applications/stored_program/RUN/dev/api_experiments/juice.h", "C++", 0, 9, 0, 4, 10, 23
"/home/unlv/Desktop/rsa306b_api_applications/stored_program/RUN/dev/api_experiments/main.cpp", "C++", 0, 12, 0, 5, 7, 24
"/home/unlv/Desktop/rsa306b_api_applications/stored_program/RUN/dev/computer_vision/compv.py", "Python", 15, 0, 0, 14, 11, 40
"/home/unlv/Desktop/rsa306b_api_applications/stored_program/RUN/dev/graphing/test.py", "Python", 113, 0, 0, 15, 33, 161
"/home/unlv/Desktop/rsa306b_api_applications/stored_program/RUN/dev/integrated_test_v1/plot_spectrum.py", "Python", 23, 0, 0, 93, 34, 150
"/home/unlv/Desktop/rsa306b_api_applications/stored_program/RUN/dev/integrated_test_v1/test_v1.py", "Python", 121, 0, 0, 17, 35, 173
"/home/unlv/Desktop/rsa306b_api_applications/stored_program/RUN/dev/try_binders/dummy.py", "Python", 41, 0, 0, 15, 20, 76
"/home/unlv/Desktop/rsa306b_api_applications/stored_program/RUN/rsagui.py", "Python", 13, 0, 0, 15, 23, 51
"/home/unlv/Desktop/rsa306b_api_applications/stored_program/RUN/top.py", "Python", 5, 0, 0, 15, 20, 40
"/home/unlv/Desktop/rsa306b_api_applications/stored_program/SRC/rsa_cpp/program_core/common_utility/common_utility.h", "C++", 0, -230, 0, -111, -28, -369
"/home/unlv/Desktop/rsa306b_api_applications/stored_program/SRC/rsa_cpp/program_core/common_utility/cu_batch_decode.cpp", "C++", 0, -125, 0, -33, -17, -175
"/home/unlv/Desktop/rsa306b_api_applications/stored_program/SRC/rsa_cpp/program_core/common_utility/cu_codez.cpp", "C++", 0, -93, 0, -53, -36, -182
"/home/unlv/Desktop/rsa306b_api_applications/stored_program/SRC/rsa_cpp/program_core/common_utility/cu_common_utility.cpp", "C++", 0, -35, 0, -23, -17, -75
"/home/unlv/Desktop/rsa306b_api_applications/stored_program/SRC/rsa_cpp/program_core/common_utility/cu_decode.cpp", "C++", 0, -238, 0, -28, -36, -302
"/home/unlv/Desktop/rsa306b_api_applications/stored_program/SRC/rsa_cpp/program_core/common_utility/cu_exe_1.cpp", "C++", 0, -115, 0, -37, -35, -187
"/home/unlv/Desktop/rsa306b_api_applications/stored_program/SRC/rsa_cpp/program_core/common_utility/cu_file_modification.cpp", "C++", 0, -250, 0, -87, -54, -391
"/home/unlv/Desktop/rsa306b_api_applications/stored_program/SRC/rsa_cpp/program_core/common_utility/cu_find_file_info.cpp", "C++", 0, -375, 0, -76, -64, -515
"/home/unlv/Desktop/rsa306b_api_applications/stored_program/SRC/rsa_cpp/program_core/common_utility/cu_ifstream_acq_status.cpp", "C++", 0, -60, 0, -19, -14, -93
"/home/unlv/Desktop/rsa306b_api_applications/stored_program/SRC/rsa_cpp/program_core/common_utility/cu_iqblk_acq_status.cpp", "C++", 0, -72, 0, -19, -16, -107
"/home/unlv/Desktop/rsa306b_api_applications/stored_program/SRC/rsa_cpp/program_core/common_utility/cu_iqstream_acq_status.cpp", "C++", 0, -120, 0, -18, -23, -161
"/home/unlv/Desktop/rsa306b_api_applications/stored_program/SRC/rsa_cpp/program_core/common_utility/cu_spectrum_acq_status.cpp", "C++", 0, -72, 0, -18, -15, -105
"/home/unlv/Desktop/rsa306b_api_applications/stored_program/SRC/rsa_cpp/program_core/common_utility/cu_timing.cpp", "C++", 0, -333, 0, -123, -91, -547
"/home/unlv/Desktop/rsa306b_api_applications/stored_program/SRC/rsa_cpp/program_core/common_utility/cu_wchar_2_char.cpp", "C++", 0, -91, 0, -32, -21, -144
"/home/unlv/Desktop/rsa306b_api_applications/stored_program/SRC/rsa_cpp/program_core/control/RSA_API.h", "C++", 0, -782, 0, -175, -139, -1096
"/home/unlv/Desktop/rsa306b_api_applications/stored_program/SRC/rsa_cpp/program_core/control/codez.h", "C++", 0, -85, 0, -9, -9, -103
"/home/unlv/Desktop/rsa306b_api_applications/stored_program/SRC/rsa_cpp/program_core/control/common_libraries.h", "C++", 0, -26, 0, -7, -11, -44
"/home/unlv/Desktop/rsa306b_api_applications/stored_program/SRC/rsa_cpp/program_core/control/constant_expersions.h", "C++", 0, -277, 0, -30, -35, -342
"/home/unlv/Desktop/rsa306b_api_applications/stored_program/SRC/rsa_cpp/program_core/control/de_bug/de_bug.cpp", "C++", 0, -11, 0, -8, -9, -28
"/home/unlv/Desktop/rsa306b_api_applications/stored_program/SRC/rsa_cpp/program_core/control/de_bug/de_bug.h", "C++", 0, -18, 0, -8, -12, -38
"/home/unlv/Desktop/rsa306b_api_applications/stored_program/SRC/rsa_cpp/program_core/control/de_bug/debug_functions.cpp", "C++", 0, -127, 0, -38, -30, -195
"/home/unlv/Desktop/rsa306b_api_applications/stored_program/SRC/rsa_cpp/program_core/control/globalz.cpp", "C++", 0, -5, 0, -8, -9, -22
"/home/unlv/Desktop/rsa306b_api_applications/stored_program/SRC/rsa_cpp/program_core/control/globalz.h", "C++", 0, -11, 0, -6, -15, -32
"/home/unlv/Desktop/rsa306b_api_applications/stored_program/SRC/rsa_cpp/program_core/control/resourcez.h", "C++", 0, -59, 0, -42, -33, -134
"/home/unlv/Desktop/rsa306b_api_applications/stored_program/SRC/rsa_cpp/program_core/main.cpp", "C++", 0, -170, 0, -47, -27, -244
"/home/unlv/Desktop/rsa306b_api_applications/stored_program/SRC/rsa_cpp/program_core/r3f_manager/r3f_batch_process_files.cpp", "C++", 0, -152, 0, -26, -16, -194
"/home/unlv/Desktop/rsa306b_api_applications/stored_program/SRC/rsa_cpp/program_core/r3f_manager/r3f_copy_vars.cpp", "C++", 0, -81, 0, -20, -16, -117
"/home/unlv/Desktop/rsa306b_api_applications/stored_program/SRC/rsa_cpp/program_core/r3f_manager/r3f_init.cpp", "C++", 0, -96, 0, -16, -20, -132
"/home/unlv/Desktop/rsa306b_api_applications/stored_program/SRC/rsa_cpp/program_core/r3f_manager/r3f_load_file.cpp", "C++", 0, -113, 0, -38, -14, -165
"/home/unlv/Desktop/rsa306b_api_applications/stored_program/SRC/rsa_cpp/program_core/r3f_manager/r3f_manager.cpp", "C++", 0, -30, 0, -26, -17, -73
"/home/unlv/Desktop/rsa306b_api_applications/stored_program/SRC/rsa_cpp/program_core/r3f_manager/r3f_manager_class.h", "C++", 0, -51, 0, -5, -18, -74
"/home/unlv/Desktop/rsa306b_api_applications/stored_program/SRC/rsa_cpp/program_core/r3f_manager/r3f_manager_struct.h", "C++", 0, -69, 0, -29, -22, -120
"/home/unlv/Desktop/rsa306b_api_applications/stored_program/SRC/rsa_cpp/program_core/r3f_manager/r3f_populate_data.cpp", "C++", 0, -97, 0, -18, -17, -132
"/home/unlv/Desktop/rsa306b_api_applications/stored_program/SRC/rsa_cpp/program_core/r3f_manager/r3f_populate_header.cpp", "C++", 0, -452, 0, -68, -49, -569
"/home/unlv/Desktop/rsa306b_api_applications/stored_program/SRC/rsa_cpp/program_core/r3f_manager/r3f_write_csv.cpp", "C++", 0, -59, 0, -24, -18, -101
"/home/unlv/Desktop/rsa306b_api_applications/stored_program/SRC/rsa_cpp/program_core/rsa306b/rsa306b_ALIGN/rsa306b_align_copy.cpp", "C++", 0, -31, 0, -23, -19, -73
"/home/unlv/Desktop/rsa306b_api_applications/stored_program/SRC/rsa_cpp/program_core/rsa306b/rsa306b_ALIGN/rsa306b_align_get.cpp", "C++", 0, -61, 0, -23, -19, -103
"/home/unlv/Desktop/rsa306b_api_applications/stored_program/SRC/rsa_cpp/program_core/rsa306b/rsa306b_ALIGN/rsa306b_align_init.cpp", "C++", 0, -11, 0, -14, -8, -33
"/home/unlv/Desktop/rsa306b_api_applications/stored_program/SRC/rsa_cpp/program_core/rsa306b/rsa306b_ALIGN/rsa306b_align_print.cpp", "C++", 0, -12, 0, -15, -8, -35
"/home/unlv/Desktop/rsa306b_api_applications/stored_program/SRC/rsa_cpp/program_core/rsa306b/rsa306b_ALIGN/rsa306b_align_struct.h", "C++", 0, -12, 0, -35, -23, -70
"/home/unlv/Desktop/rsa306b_api_applications/stored_program/SRC/rsa_cpp/program_core/rsa306b/rsa306b_ALIGN/rsa306b_align_user.cpp", "C++", 0, -61, 0, -26, -18, -105
"/home/unlv/Desktop/rsa306b_api_applications/stored_program/SRC/rsa_cpp/program_core/rsa306b/rsa306b_AUDIO/rsa306b_audio_copy.cpp", "C++", 0, -93, 0, -53, -49, -195
"/home/unlv/Desktop/rsa306b_api_applications/stored_program/SRC/rsa_cpp/program_core/rsa306b/rsa306b_AUDIO/rsa306b_audio_get.cpp", "C++", 0, -141, 0, -38, -39, -218
"/home/unlv/Desktop/rsa306b_api_applications/stored_program/SRC/rsa_cpp/program_core/rsa306b/rsa306b_AUDIO/rsa306b_audio_init.cpp", "C++", 0, -17, 0, -14, -9, -40
"/home/unlv/Desktop/rsa306b_api_applications/stored_program/SRC/rsa_cpp/program_core/rsa306b/rsa306b_AUDIO/rsa306b_audio_print.cpp", "C++", 0, -27, 0, -14, -8, -49
"/home/unlv/Desktop/rsa306b_api_applications/stored_program/SRC/rsa_cpp/program_core/rsa306b/rsa306b_AUDIO/rsa306b_audio_set.cpp", "C++", 0, -201, 0, -50, -40, -291
"/home/unlv/Desktop/rsa306b_api_applications/stored_program/SRC/rsa_cpp/program_core/rsa306b/rsa306b_AUDIO/rsa306b_audio_struct.h", "C++", 0, -30, 0, -79, -34, -143
"/home/unlv/Desktop/rsa306b_api_applications/stored_program/SRC/rsa_cpp/program_core/rsa306b/rsa306b_AUDIO/rsa306b_audio_user.cpp", "C++", 0, -102, 0, -51, -21, -174
"/home/unlv/Desktop/rsa306b_api_applications/stored_program/SRC/rsa_cpp/program_core/rsa306b/rsa306b_AUDIO/rsa306b_audio_write_csv.cpp", "C++", 0, -63, 0, -18, -14, -95
"/home/unlv/Desktop/rsa306b_api_applications/stored_program/SRC/rsa_cpp/program_core/rsa306b/rsa306b_CONFIG/rsa306b_config_copy.cpp", "C++", 0, -71, 0, -43, -39, -153
"/home/unlv/Desktop/rsa306b_api_applications/stored_program/SRC/rsa_cpp/program_core/rsa306b/rsa306b_CONFIG/rsa306b_config_get.cpp", "C++", 0, -167, 0, -43, -40, -250
"/home/unlv/Desktop/rsa306b_api_applications/stored_program/SRC/rsa_cpp/program_core/rsa306b/rsa306b_CONFIG/rsa306b_config_init.cpp", "C++", 0, -15, 0, -14, -8, -37
"/home/unlv/Desktop/rsa306b_api_applications/stored_program/SRC/rsa_cpp/program_core/rsa306b/rsa306b_CONFIG/rsa306b_config_print.cpp", "C++", 0, -24, 0, -14, -7, -45
"/home/unlv/Desktop/rsa306b_api_applications/stored_program/SRC/rsa_cpp/program_core/rsa306b/rsa306b_CONFIG/rsa306b_config_set.cpp", "C++", 0, -137, 0, -34, -31, -202
"/home/unlv/Desktop/rsa306b_api_applications/stored_program/SRC/rsa_cpp/program_core/rsa306b/rsa306b_CONFIG/rsa306b_config_struct.h", "C++", 0, -24, 0, -78, -29, -131
"/home/unlv/Desktop/rsa306b_api_applications/stored_program/SRC/rsa_cpp/program_core/rsa306b/rsa306b_CONFIG/rsa306b_config_user.cpp", "C++", 0, -24, 0, -13, -7, -44
"/home/unlv/Desktop/rsa306b_api_applications/stored_program/SRC/rsa_cpp/program_core/rsa306b/rsa306b_DEVICE/rsa306b_device_copy.cpp", "C++", 0, -105, 0, -58, -55, -218
"/home/unlv/Desktop/rsa306b_api_applications/stored_program/SRC/rsa_cpp/program_core/rsa306b/rsa306b_DEVICE/rsa306b_device_get.cpp", "C++", 0, -162, 0, -64, -36, -262
"/home/unlv/Desktop/rsa306b_api_applications/stored_program/SRC/rsa_cpp/program_core/rsa306b/rsa306b_DEVICE/rsa306b_device_init.cpp", "C++", 0, -30, 0, -15, -12, -57
"/home/unlv/Desktop/rsa306b_api_applications/stored_program/SRC/rsa_cpp/program_core/rsa306b/rsa306b_DEVICE/rsa306b_device_print.cpp", "C++", 0, -30, 0, -15, -8, -53
"/home/unlv/Desktop/rsa306b_api_applications/stored_program/SRC/rsa_cpp/program_core/rsa306b/rsa306b_DEVICE/rsa306b_device_struct.h", "C++", 0, -24, 0, -119, -43, -186
"/home/unlv/Desktop/rsa306b_api_applications/stored_program/SRC/rsa_cpp/program_core/rsa306b/rsa306b_DEVICE/rsa306b_device_user_checker.cpp", "C++", 0, -26, 0, -35, -17, -78
"/home/unlv/Desktop/rsa306b_api_applications/stored_program/SRC/rsa_cpp/program_core/rsa306b/rsa306b_DEVICE/rsa306b_device_user_connector.cpp", "C++", 0, -107, 0, -25, -24, -156
"/home/unlv/Desktop/rsa306b_api_applications/stored_program/SRC/rsa_cpp/program_core/rsa306b/rsa306b_DEVICE/rsa306b_device_user_operator.cpp", "C++", 0, -142, 0, -46, -29, -217
"/home/unlv/Desktop/rsa306b_api_applications/stored_program/SRC/rsa_cpp/program_core/rsa306b/rsa306b_DPX/rsa306b_dpx_copy.cpp", "C++", 0, -102, 0, -71, -49, -222
"/home/unlv/Desktop/rsa306b_api_applications/stored_program/SRC/rsa_cpp/program_core/rsa306b/rsa306b_DPX/rsa306b_dpx_struct.h", "C++", 0, -150, 0, -334, -79, -563
"/home/unlv/Desktop/rsa306b_api_applications/stored_program/SRC/rsa_cpp/program_core/rsa306b/rsa306b_GP/rsa306b_class.cpp", "C++", 0, -105, 0, -57, -42, -204
"/home/unlv/Desktop/rsa306b_api_applications/stored_program/SRC/rsa_cpp/program_core/rsa306b/rsa306b_GP/rsa306b_gp_confirm.cpp", "C++", 0, -57, 0, -40, -27, -124
"/home/unlv/Desktop/rsa306b_api_applications/stored_program/SRC/rsa_cpp/program_core/rsa306b/rsa306b_GP/rsa306b_gp_print.cpp", "C++", 0, -34, 0, -23, -16, -73
"/home/unlv/Desktop/rsa306b_api_applications/stored_program/SRC/rsa_cpp/program_core/rsa306b/rsa306b_IFSTREAM/rsa306b_ifstream_copy.cpp", "C++", 0, -295, 0, -149, -146, -590
"/home/unlv/Desktop/rsa306b_api_applications/stored_program/SRC/rsa_cpp/program_core/rsa306b/rsa306b_IFSTREAM/rsa306b_ifstream_get.cpp", "C++", 0, -188, 0, -38, -36, -262
"/home/unlv/Desktop/rsa306b_api_applications/stored_program/SRC/rsa_cpp/program_core/rsa306b/rsa306b_IFSTREAM/rsa306b_ifstream_init.cpp", "C++", 0, -47, 0, -15, -18, -80
"/home/unlv/Desktop/rsa306b_api_applications/stored_program/SRC/rsa_cpp/program_core/rsa306b/rsa306b_IFSTREAM/rsa306b_ifstream_print.cpp", "C++", 0, -54, 0, -13, -8, -75
"/home/unlv/Desktop/rsa306b_api_applications/stored_program/SRC/rsa_cpp/program_core/rsa306b/rsa306b_IFSTREAM/rsa306b_ifstream_set.cpp", "C++", 0, -260, 0, -55, -51, -366
"/home/unlv/Desktop/rsa306b_api_applications/stored_program/SRC/rsa_cpp/program_core/rsa306b/rsa306b_IFSTREAM/rsa306b_ifstream_struct.h", "C++", 0, -75, 0, -170, -57, -302
"/home/unlv/Desktop/rsa306b_api_applications/stored_program/SRC/rsa_cpp/program_core/rsa306b/rsa306b_IFSTREAM/rsa306b_ifstream_user_adc_data.cpp", "C++", 0, -152, 0, -49, -29, -230
"/home/unlv/Desktop/rsa306b_api_applications/stored_program/SRC/rsa_cpp/program_core/rsa306b/rsa306b_IFSTREAM/rsa306b_ifstream_user_framed_adc_data.cpp", "C++", 0, -118, 0, -48, -23, -189
"/home/unlv/Desktop/rsa306b_api_applications/stored_program/SRC/rsa_cpp/program_core/rsa306b/rsa306b_IFSTREAM/rsa306b_ifstream_user_record_r3f.cpp", "C++", 0, -54, 0, -29, -11, -94
"/home/unlv/Desktop/rsa306b_api_applications/stored_program/SRC/rsa_cpp/program_core/rsa306b/rsa306b_IFSTREAM/rsa306b_ifstream_user_write_csv_equalization.cpp", "C++", 0, -73, 0, -20, -14, -107
"/home/unlv/Desktop/rsa306b_api_applications/stored_program/SRC/rsa_cpp/program_core/rsa306b/rsa306b_IQBLK/rsa306b_iqblk_acquire.cpp", "C++", 0, -180, 0, -29, -34, -243
"/home/unlv/Desktop/rsa306b_api_applications/stored_program/SRC/rsa_cpp/program_core/rsa306b/rsa306b_IQBLK/rsa306b_iqblk_copy.cpp", "C++", 0, -133, 0, -67, -64, -264
"/home/unlv/Desktop/rsa306b_api_applications/stored_program/SRC/rsa_cpp/program_core/rsa306b/rsa306b_IQBLK/rsa306b_iqblk_get.cpp", "C++", 0, -192, 0, -48, -44, -284
"/home/unlv/Desktop/rsa306b_api_applications/stored_program/SRC/rsa_cpp/program_core/rsa306b/rsa306b_IQBLK/rsa306b_iqblk_init.cpp", "C++", 0, -31, 0, -13, -13, -57
"/home/unlv/Desktop/rsa306b_api_applications/stored_program/SRC/rsa_cpp/program_core/rsa306b/rsa306b_IQBLK/rsa306b_iqblk_print.cpp", "C++", 0, -23, 0, -13, -8, -44
"/home/unlv/Desktop/rsa306b_api_applications/stored_program/SRC/rsa_cpp/program_core/rsa306b/rsa306b_IQBLK/rsa306b_iqblk_set.cpp", "C++", 0, -138, 0, -35, -32, -205
"/home/unlv/Desktop/rsa306b_api_applications/stored_program/SRC/rsa_cpp/program_core/rsa306b/rsa306b_IQBLK/rsa306b_iqblk_struct.h", "C++", 0, -41, 0, -130, -41, -212
"/home/unlv/Desktop/rsa306b_api_applications/stored_program/SRC/rsa_cpp/program_core/rsa306b/rsa306b_IQBLK/rsa306b_iqblk_user.cpp", "C++", 0, -89, 0, -18, -20, -127
"/home/unlv/Desktop/rsa306b_api_applications/stored_program/SRC/rsa_cpp/program_core/rsa306b/rsa306b_IQSTREAM/rsa306b_iqstream_acquire.cpp", "C++", 0, -178, 0, -50, -33, -261
"/home/unlv/Desktop/rsa306b_api_applications/stored_program/SRC/rsa_cpp/program_core/rsa306b/rsa306b_IQSTREAM/rsa306b_iqstream_copy.cpp", "C++", 0, -247, 0, -111, -106, -464
"/home/unlv/Desktop/rsa306b_api_applications/stored_program/SRC/rsa_cpp/program_core/rsa306b/rsa306b_IQSTREAM/rsa306b_iqstream_get.cpp", "C++", 0, -168, 0, -48, -39, -255
"/home/unlv/Desktop/rsa306b_api_applications/stored_program/SRC/rsa_cpp/program_core/rsa306b/rsa306b_IQSTREAM/rsa306b_iqstream_init.cpp", "C++", 0, -52, 0, -17, -16, -85
"/home/unlv/Desktop/rsa306b_api_applications/stored_program/SRC/rsa_cpp/program_core/rsa306b/rsa306b_IQSTREAM/rsa306b_iqstream_print.cpp", "C++", 0, -83, 0, -14, -12, -109
"/home/unlv/Desktop/rsa306b_api_applications/stored_program/SRC/rsa_cpp/program_core/rsa306b/rsa306b_IQSTREAM/rsa306b_iqstream_set.cpp", "C++", 0, -323, 0, -56, -51, -430
"/home/unlv/Desktop/rsa306b_api_applications/stored_program/SRC/rsa_cpp/program_core/rsa306b/rsa306b_IQSTREAM/rsa306b_iqstream_struct.h", "C++", 0, -68, 0, -217, -60, -345
"/home/unlv/Desktop/rsa306b_api_applications/stored_program/SRC/rsa_cpp/program_core/rsa306b/rsa306b_IQSTREAM/rsa306b_iqstream_user.cpp", "C++", 0, -83, 0, -35, -27, -145
"/home/unlv/Desktop/rsa306b_api_applications/stored_program/SRC/rsa_cpp/program_core/rsa306b/rsa306b_IQSTREAM/rsa306b_iqstream_user_record_siq.cpp", "C++", 0, -52, 0, -96, -13, -161
"/home/unlv/Desktop/rsa306b_api_applications/stored_program/SRC/rsa_cpp/program_core/rsa306b/rsa306b_IQSTREAM/rsa306b_iqstream_write_csv.cpp", "C++", 0, -172, 0, -36, -28, -236
"/home/unlv/Desktop/rsa306b_api_applications/stored_program/SRC/rsa_cpp/program_core/rsa306b/rsa306b_PLAYBACK/rsa306b_playback_struct.h", "C++", 0, -27, 0, -41, -26, -94
"/home/unlv/Desktop/rsa306b_api_applications/stored_program/SRC/rsa_cpp/program_core/rsa306b/rsa306b_REFTIME/rsa306b_reftime_copy.cpp", "C++", 0, -87, 0, -48, -44, -179
"/home/unlv/Desktop/rsa306b_api_applications/stored_program/SRC/rsa_cpp/program_core/rsa306b/rsa306b_REFTIME/rsa306b_reftime_get.cpp", "C++", 0, -160, 0, -42, -40, -242
"/home/unlv/Desktop/rsa306b_api_applications/stored_program/SRC/rsa_cpp/program_core/rsa306b/rsa306b_REFTIME/rsa306b_reftime_init.cpp", "C++", 0, -23, 0, -14, -12, -49
"/home/unlv/Desktop/rsa306b_api_applications/stored_program/SRC/rsa_cpp/program_core/rsa306b/rsa306b_REFTIME/rsa306b_reftime_print.cpp", "C++", 0, -31, 0, -13, -12, -56
"/home/unlv/Desktop/rsa306b_api_applications/stored_program/SRC/rsa_cpp/program_core/rsa306b/rsa306b_REFTIME/rsa306b_reftime_struct.h", "C++", 0, -34, 0, -86, -32, -152
"/home/unlv/Desktop/rsa306b_api_applications/stored_program/SRC/rsa_cpp/program_core/rsa306b/rsa306b_REFTIME/rsa306b_reftime_user.cpp", "C++", 0, -118, 0, -42, -25, -185
"/home/unlv/Desktop/rsa306b_api_applications/stored_program/SRC/rsa_cpp/program_core/rsa306b/rsa306b_SPECTRUM/rsa306b_spectrum_copy.cpp", "C++", 0, -165, 0, -73, -73, -311
"/home/unlv/Desktop/rsa306b_api_applications/stored_program/SRC/rsa_cpp/program_core/rsa306b/rsa306b_SPECTRUM/rsa306b_spectrum_get.cpp", "C++", 0, -148, 0, -38, -35, -221
"/home/unlv/Desktop/rsa306b_api_applications/stored_program/SRC/rsa_cpp/program_core/rsa306b/rsa306b_SPECTRUM/rsa306b_spectrum_helper.cpp", "C++", 0, -114, 0, -28, -22, -164
"/home/unlv/Desktop/rsa306b_api_applications/stored_program/SRC/rsa_cpp/program_core/rsa306b/rsa306b_SPECTRUM/rsa306b_spectrum_init_default.cpp", "C++", 0, -71, 0, -20, -23, -114
"/home/unlv/Desktop/rsa306b_api_applications/stored_program/SRC/rsa_cpp/program_core/rsa306b/rsa306b_SPECTRUM/rsa306b_spectrum_print.cpp", "C++", 0, -73, 0, -16, -9, -98
"/home/unlv/Desktop/rsa306b_api_applications/stored_program/SRC/rsa_cpp/program_core/rsa306b/rsa306b_SPECTRUM/rsa306b_spectrum_set.cpp", "C++", 0, -222, 0, -32, -31, -285
"/home/unlv/Desktop/rsa306b_api_applications/stored_program/SRC/rsa_cpp/program_core/rsa306b/rsa306b_SPECTRUM/rsa306b_spectrum_struct.h", "C++", 0, -75, 0, -126, -39, -240
"/home/unlv/Desktop/rsa306b_api_applications/stored_program/SRC/rsa_cpp/program_core/rsa306b/rsa306b_SPECTRUM/rsa306b_spectrum_user.cpp", "C++", 0, -119, 0, -61, -23, -203
"/home/unlv/Desktop/rsa306b_api_applications/stored_program/SRC/rsa_cpp/program_core/rsa306b/rsa306b_TRIG/rsa306b_trig_copy.cpp", "C++", 0, -73, 0, -43, -40, -156
"/home/unlv/Desktop/rsa306b_api_applications/stored_program/SRC/rsa_cpp/program_core/rsa306b/rsa306b_TRIG/rsa306b_trig_get.cpp", "C++", 0, -169, 0, -43, -40, -252
"/home/unlv/Desktop/rsa306b_api_applications/stored_program/SRC/rsa_cpp/program_core/rsa306b/rsa306b_TRIG/rsa306b_trig_init.cpp", "C++", 0, -17, 0, -13, -10, -40
"/home/unlv/Desktop/rsa306b_api_applications/stored_program/SRC/rsa_cpp/program_core/rsa306b/rsa306b_TRIG/rsa306b_trig_print.cpp", "C++", 0, -38, 0, -13, -8, -59
"/home/unlv/Desktop/rsa306b_api_applications/stored_program/SRC/rsa_cpp/program_core/rsa306b/rsa306b_TRIG/rsa306b_trig_set.cpp", "C++", 0, -244, 0, -49, -45, -338
"/home/unlv/Desktop/rsa306b_api_applications/stored_program/SRC/rsa_cpp/program_core/rsa306b/rsa306b_TRIG/rsa306b_trig_struct.h", "C++", 0, -26, 0, -81, -30, -137
"/home/unlv/Desktop/rsa306b_api_applications/stored_program/SRC/rsa_cpp/program_core/rsa306b/rsa306b_TRIG/rsa306b_trig_user.cpp", "C++", 0, -26, 0, -17, -9, -52
"/home/unlv/Desktop/rsa306b_api_applications/stored_program/SRC/rsa_cpp/program_core/rsa306b/rsa306b_class.h", "C++", 0, -413, 0, -552, -46, -1011
"/home/unlv/Desktop/rsa306b_api_applications/stored_program/SRC/rsa_cpp/program_core/rsa306b/rsa306b_special/rsa306b_scan_dump.cpp", "C++", 0, -263, 0, -32, -18, -313
"/home/unlv/Desktop/rsa306b_api_applications/stored_program/SRC/rsa_cpp/program_core/rsa306b/rsa306b_special/rsa306b_spectrum_scanner.cpp", "C++", 0, -246, 0, -23, -28, -297
"/home/unlv/Desktop/rsa306b_api_applications/stored_program/SRC/rsa_cpp/program_core/rsa306b/rsa306b_struct.h", "C++", 0, -31, 0, -16, -22, -69
"/home/unlv/Desktop/rsa306b_api_applications/stored_program/SRC/rsa_cpp/program_core/siq_manager/siq_batch_process_files.cpp", "C++", 0, -120, 0, -24, -15, -159
"/home/unlv/Desktop/rsa306b_api_applications/stored_program/SRC/rsa_cpp/program_core/siq_manager/siq_copy.cpp", "C++", 0, -111, 0, -17, -32, -160
"/home/unlv/Desktop/rsa306b_api_applications/stored_program/SRC/rsa_cpp/program_core/siq_manager/siq_init.cpp", "C++", 0, -95, 0, -37, -37, -169
"/home/unlv/Desktop/rsa306b_api_applications/stored_program/SRC/rsa_cpp/program_core/siq_manager/siq_load_file.cpp", "C++", 0, -87, 0, -38, -15, -140
"/home/unlv/Desktop/rsa306b_api_applications/stored_program/SRC/rsa_cpp/program_core/siq_manager/siq_manager.cpp", "C++", 0, -33, 0, -26, -16, -75
"/home/unlv/Desktop/rsa306b_api_applications/stored_program/SRC/rsa_cpp/program_core/siq_manager/siq_manager_class.h", "C++", 0, -48, 0, -5, -18, -71
"/home/unlv/Desktop/rsa306b_api_applications/stored_program/SRC/rsa_cpp/program_core/siq_manager/siq_manager_struct.h", "C++", 0, -70, 0, -32, -32, -134
"/home/unlv/Desktop/rsa306b_api_applications/stored_program/SRC/rsa_cpp/program_core/siq_manager/siq_populate_data.cpp", "C++", 0, -162, 0, -17, -9, -188
"/home/unlv/Desktop/rsa306b_api_applications/stored_program/SRC/rsa_cpp/program_core/siq_manager/siq_populate_header.cpp", "C++", 0, -897, 0, -44, -11, -952
"/home/unlv/Desktop/rsa306b_api_applications/stored_program/SRC/rsa_cpp/program_core/siq_manager/siq_write.cpp", "C++", 0, -214, 0, -31, -57, -302
"/home/unlv/Desktop/rsa306b_api_applications/stored_program/SRC/rsa_cpp/program_test/tasks/task_998.cpp", "C++", 0, -86, 0, -6, -13, -105
"/home/unlv/Desktop/rsa306b_api_applications/stored_program/SRC/rsa_cpp/program_test/tasks/task_999.cpp", "C++", 0, -32, 0, -22, -15, -69
"/home/unlv/Desktop/rsa306b_api_applications/stored_program/SRC/rsa_cpp/program_test/test_selector.cpp", "C++", 0, -35, 0, -5, -16, -56
"/home/unlv/Desktop/rsa306b_api_applications/stored_program/SRC/rsa_cpp/program_test/testz.h", "C++", 0, -31, 0, -31, -19, -81
"/home/unlv/Desktop/rsa306b_api_applications/stored_program/SRC/rsa_cpp/program_test/units/unit_test_0.cpp", "C++", 0, -17, 0, -18, -11, -46
"/home/unlv/Desktop/rsa306b_api_applications/stored_program/SRC/rsa_cpp/program_test/units/unit_test_1.cpp", "C++", 0, -436, 0, -129, -83, -648
"/home/unlv/Desktop/rsa306b_api_applications/stored_program/SRC/rsa_cpp/program_test/units/unit_test_10.cpp", "C++", 0, -108, 0, -20, -25, -153
"/home/unlv/Desktop/rsa306b_api_applications/stored_program/SRC/rsa_cpp/program_test/units/unit_test_11.cpp", "C++", 0, -180, 0, -27, -34, -241
"/home/unlv/Desktop/rsa306b_api_applications/stored_program/SRC/rsa_cpp/program_test/units/unit_test_12.cpp", "C++", 0, -150, 0, -30, -44, -224
"/home/unlv/Desktop/rsa306b_api_applications/stored_program/SRC/rsa_cpp/program_test/units/unit_test_13.cpp", "C++", 0, -189, 0, -21, -51, -261
"/home/unlv/Desktop/rsa306b_api_applications/stored_program/SRC/rsa_cpp/program_test/units/unit_test_14.cpp", "C++", 0, -182, 0, -22, -49, -253
"/home/unlv/Desktop/rsa306b_api_applications/stored_program/SRC/rsa_cpp/program_test/units/unit_test_2.cpp", "C++", 0, -69, 0, -23, -28, -120
"/home/unlv/Desktop/rsa306b_api_applications/stored_program/SRC/rsa_cpp/program_test/units/unit_test_3.cpp", "C++", 0, -125, 0, -29, -42, -196
"/home/unlv/Desktop/rsa306b_api_applications/stored_program/SRC/rsa_cpp/program_test/units/unit_test_4.cpp", "C++", 0, -60, 0, -19, -25, -104
"/home/unlv/Desktop/rsa306b_api_applications/stored_program/SRC/rsa_cpp/program_test/units/unit_test_5.cpp", "C++", 0, -59, 0, -18, -26, -103
"/home/unlv/Desktop/rsa306b_api_applications/stored_program/SRC/rsa_cpp/program_test/units/unit_test_6.cpp", "C++", 0, -72, 0, -21, -28, -121
"/home/unlv/Desktop/rsa306b_api_applications/stored_program/SRC/rsa_cpp/program_test/units/unit_test_7.cpp", "C++", 0, -145, 0, -26, -34, -205
"/home/unlv/Desktop/rsa306b_api_applications/stored_program/SRC/rsa_cpp/program_test/units/unit_test_8.cpp", "C++", 0, -58, 0, -39, -29, -126
"/home/unlv/Desktop/rsa306b_api_applications/stored_program/SRC/rsa_cpp/program_test/units/unit_test_9.cpp", "C++", 0, -168, 0, -42, -48, -258
"/home/unlv/Desktop/rsa306b_api_applications/stored_program/SRC/rsa_cpp/program_test/wait_enter_clear.cpp", "C++", 0, -22, 0, -7, -17, -46
"/home/unlv/Desktop/rsa306b_api_applications/stored_program/SRC/rsa_cpp/python_interface/python_interface.h", "C++", 0, -69, 0, -14, -22, -105
"/home/unlv/Desktop/rsa306b_api_applications/stored_program/SRC/rsa_cpp/python_interface/raw_r3f.cpp", "C++", 0, -114, 0, -10, -18, -142
"/home/unlv/Desktop/rsa306b_api_applications/stored_program/SRC/rsa_cpp/python_interface/raw_siq.cpp", "C++", 0, -60, 0, -8, -14, -82
"/home/unlv/Desktop/rsa306b_api_applications/stored_program/SRC/rsa_cpp/python_interface/rsa_config.cpp", "C++", 0, -17, 0, -8, -11, -36
"/home/unlv/Desktop/rsa306b_api_applications/stored_program/SRC/rsa_cpp/python_interface/rsa_device.cpp", "C++", 0, -38, 0, -22, -17, -77
"/home/unlv/Desktop/rsa306b_api_applications/stored_program/SRC/rsa_cpp/python_interface/rsa_gp.cpp", "C++", 0, -18, 0, -10, -12, -40
"/home/unlv/Desktop/rsa306b_api_applications/stored_program/SRC/rsa_cpp/python_interface/rsa_ifstream.cpp", "C++", 0, -81, 0, -18, -18, -117
"/home/unlv/Desktop/rsa306b_api_applications/stored_program/SRC/rsa_cpp/python_interface/rsa_iqblk.cpp", "C++", 0, -29, 0, -13, -21, -63
"/home/unlv/Desktop/rsa306b_api_applications/stored_program/SRC/rsa_cpp/python_interface/rsa_iqstream.cpp", "C++", 0, -67, 0, -16, -25, -108
"/home/unlv/Desktop/rsa306b_api_applications/stored_program/SRC/rsa_cpp/python_interface/rsa_spectrum.cpp", "C++", 0, -51, 0, -18, -16, -85
"/home/unlv/Desktop/rsa306b_api_applications/stored_program/SRC/rsa_cpp/python_interface/special.cpp", "C++", 0, -124, 0, -10, -19, -153
"/home/unlv/Desktop/rsa306b_api_applications/stored_program/SRC/unlv_rsapy/__init__.py", "Python", -66, 0, 0, -15, -21, -102
"/home/unlv/Desktop/rsa306b_api_applications/stored_program/SRC/unlv_rsapy/configuration.py", "Python", -16, 0, 0, -7, -7, -30
"/home/unlv/Desktop/rsa306b_api_applications/stored_program/SRC/unlv_rsapy/funz/admin.py", "Python", -96, 0, 0, -4, -23, -123
"/home/unlv/Desktop/rsa306b_api_applications/stored_program/SRC/unlv_rsapy/funz/plot_eq.py", "Python", -35, 0, 0, -9, -8, -52
"/home/unlv/Desktop/rsa306b_api_applications/stored_program/SRC/unlv_rsapy/funz/plot_if.py", "Python", -31, 0, 0, -9, -8, -48
"/home/unlv/Desktop/rsa306b_api_applications/stored_program/SRC/unlv_rsapy/funz/plot_iq.py", "Python", -35, 0, 0, -9, -8, -52
"/home/unlv/Desktop/rsa306b_api_applications/stored_program/SRC/unlv_rsapy/funz/plot_spectrum.py", "Python", -31, 0, 0, -9, -8, -48
"/home/unlv/Desktop/rsa306b_api_applications/stored_program/SRC/unlv_rsapy/r3f_wrapper/f_r3f.py", "Python", -16, 0, 0, -4, -8, -28
"/home/unlv/Desktop/rsa306b_api_applications/stored_program/SRC/unlv_rsapy/r3f_wrapper/r3f_utility.py", "Python", -12, 0, 0, -4, -7, -23
"/home/unlv/Desktop/rsa306b_api_applications/stored_program/SRC/unlv_rsapy/rsa_wrapper/api_config.py", "Python", -8, 0, 0, -5, -6, -19
"/home/unlv/Desktop/rsa306b_api_applications/stored_program/SRC/unlv_rsapy/rsa_wrapper/api_device.py", "Python", -15, 0, 0, -5, -12, -32
"/home/unlv/Desktop/rsa306b_api_applications/stored_program/SRC/unlv_rsapy/rsa_wrapper/api_gp.py", "Python", -11, 0, 0, -5, -7, -23
"/home/unlv/Desktop/rsa306b_api_applications/stored_program/SRC/unlv_rsapy/rsa_wrapper/api_ifstream.py", "Python", -25, 0, 0, -5, -10, -40
"/home/unlv/Desktop/rsa306b_api_applications/stored_program/SRC/unlv_rsapy/rsa_wrapper/api_iqblk.py", "Python", -17, 0, 0, -5, -8, -30
"/home/unlv/Desktop/rsa306b_api_applications/stored_program/SRC/unlv_rsapy/rsa_wrapper/api_iqstream.py", "Python", -20, 0, 0, -5, -9, -34
"/home/unlv/Desktop/rsa306b_api_applications/stored_program/SRC/unlv_rsapy/rsa_wrapper/api_spectrum.py", "Python", -26, 0, 0, -5, -12, -43
"/home/unlv/Desktop/rsa306b_api_applications/stored_program/SRC/unlv_rsapy/rsa_wrapper/f_ifstream.py", "Python", -52, 0, 0, -4, -13, -69
"/home/unlv/Desktop/rsa306b_api_applications/stored_program/SRC/unlv_rsapy/rsa_wrapper/f_iqblk.py", "Python", -21, 0, 0, -4, -7, -32
"/home/unlv/Desktop/rsa306b_api_applications/stored_program/SRC/unlv_rsapy/rsa_wrapper/f_iqstream.py", "Python", -37, 0, 0, -4, -9, -50
"/home/unlv/Desktop/rsa306b_api_applications/stored_program/SRC/unlv_rsapy/rsa_wrapper/f_spectrum.py", "Python", -58, 0, 0, -4, -9, -71
"/home/unlv/Desktop/rsa306b_api_applications/stored_program/SRC/unlv_rsapy/siq_wrapper/f_siq.py", "Python", -8, 0, 0, -4, -7, -19
"/home/unlv/Desktop/rsa306b_api_applications/stored_program/SRC/unlv_rsapy/siq_wrapper/siq_utility.py", "Python", -7, 0, 0, -4, -6, -17
"/home/unlv/Desktop/rsa306b_api_applications/stored_program/SRC/unlv_rsapy/special/special.py", "Python", -53, 0, 0, -5, -7, -65
"Total", "-", -365, -18649, 17, -7006, -4770, -30773