"filename", "language", "Python", "C++", "Makefile", "comment", "blank", "total"
"/home/unlv/Desktop/rsa306b_api_applications/stored_program/RUN/dev/api_experiments/AUDIO_GetVolume.cpp", "C++", 0, 19, 0, 6, 9, 34
"/home/unlv/Desktop/rsa306b_api_applications/stored_program/RUN/dev/api_experiments/Makefile", "Makefile", 0, 0, 17, 2, 6, 25
"/home/unlv/Desktop/rsa306b_api_applications/stored_program/RUN/dev/api_experiments/juice.h", "C++", 0, 9, 0, 4, 10, 23
"/home/unlv/Desktop/rsa306b_api_applications/stored_program/RUN/dev/api_experiments/main.cpp", "C++", 0, 12, 0, 5, 7, 24
"/home/unlv/Desktop/rsa306b_api_applications/stored_program/RUN/dev/computer_vision/compv.py", "Python", 15, 0, 0, 14, 11, 40
"/home/unlv/Desktop/rsa306b_api_applications/stored_program/RUN/dev/graphing/test.py", "Python", 113, 0, 0, 15, 33, 161
"/home/unlv/Desktop/rsa306b_api_applications/stored_program/RUN/dev/integrated_test_v1/plot_spectrum.py", "Python", 23, 0, 0, 93, 34, 150
"/home/unlv/Desktop/rsa306b_api_applications/stored_program/RUN/dev/integrated_test_v1/test_v1.py", "Python", 121, 0, 0, 17, 35, 173
"/home/unlv/Desktop/rsa306b_api_applications/stored_program/RUN/dev/try_binders/dummy.py", "Python", 41, 0, 0, 15, 20, 76
"/home/unlv/Desktop/rsa306b_api_applications/stored_program/RUN/rsagui.py", "Python", 13, 0, 0, 15, 23, 51
"/home/unlv/Desktop/rsa306b_api_applications/stored_program/RUN/top.py", "Python", 5, 0, 0, 15, 20, 40
"Total", "-", 331, 40, 17, 201, 208, 797