"filename", "language", "C++", "Python", "Makefile", "Properties", "comment", "blank", "total"
"/home/unlv/Desktop/rsa306b_api_applications/stored_program/BUILD/Makefile", "Makefile", 0, 0, 210, 0, 48, 27, 285
"/home/unlv/Desktop/rsa306b_api_applications/stored_program/BUILD/test.py", "Python", 0, 10, 0, 0, 5, 15, 30
"/home/unlv/Desktop/rsa306b_api_applications/stored_program/DOC/from_tektronix/cyusb.conf", "Properties", 0, 0, 0, 17, 14, 7, 38
"/home/unlv/Desktop/rsa306b_api_applications/stored_program/RUN/dev/api_experiments/AUDIO_GetVolume.cpp", "C++", 19, 0, 0, 0, 6, 9, 34
"/home/unlv/Desktop/rsa306b_api_applications/stored_program/RUN/dev/api_experiments/Makefile", "Makefile", 0, 0, 17, 0, 2, 6, 25
"/home/unlv/Desktop/rsa306b_api_applications/stored_program/RUN/dev/api_experiments/juice.h", "C++", 9, 0, 0, 0, 4, 10, 23
"/home/unlv/Desktop/rsa306b_api_applications/stored_program/RUN/dev/api_experiments/main.cpp", "C++", 12, 0, 0, 0, 5, 7, 24
"/home/unlv/Desktop/rsa306b_api_applications/stored_program/RUN/dev/computer_vision/compv.py", "Python", 0, 15, 0, 0, 14, 11, 40
"/home/unlv/Desktop/rsa306b_api_applications/stored_program/RUN/dev/graphing/test.py", "Python", 0, 113, 0, 0, 15, 33, 161
"/home/unlv/Desktop/rsa306b_api_applications/stored_program/RUN/dev/integrated_test_v1/plot_spectrum.py", "Python", 0, 23, 0, 0, 93, 34, 150
"/home/unlv/Desktop/rsa306b_api_applications/stored_program/RUN/dev/integrated_test_v1/test_v1.py", "Python", 0, 121, 0, 0, 17, 35, 173
"/home/unlv/Desktop/rsa306b_api_applications/stored_program/RUN/dev/try_binders/dummy.py", "Python", 0, 41, 0, 0, 15, 20, 76
"/home/unlv/Desktop/rsa306b_api_applications/stored_program/RUN/rsagui.py", "Python", 0, 13, 0, 0, 15, 23, 51
"/home/unlv/Desktop/rsa306b_api_applications/stored_program/RUN/top.py", "Python", 0, 4, 0, 0, 15, 21, 40
"/home/unlv/Desktop/rsa306b_api_applications/stored_program/SRC/rsa_cpp/program_core/common_utility/common_utility.h", "C++", 62, 0, 0, 0, 74, 25, 161
"/home/unlv/Desktop/rsa306b_api_applications/stored_program/SRC/rsa_cpp/program_core/common_utility/cu_codez.cpp", "C++", 93, 0, 0, 0, 53, 36, 182
"/home/unlv/Desktop/rsa306b_api_applications/stored_program/SRC/rsa_cpp/program_core/common_utility/cu_common_utility.cpp", "C++", 33, 0, 0, 0, 23, 17, 73
"/home/unlv/Desktop/rsa306b_api_applications/stored_program/SRC/rsa_cpp/program_core/common_utility/cu_exe_1.cpp", "C++", 46, 0, 0, 0, 20, 14, 80
"/home/unlv/Desktop/rsa306b_api_applications/stored_program/SRC/rsa_cpp/program_core/common_utility/cu_help_1.cpp", "C++", 89, 0, 0, 0, 20, 16, 125
"/home/unlv/Desktop/rsa306b_api_applications/stored_program/SRC/rsa_cpp/program_core/common_utility/cu_help_decode.cpp", "C++", 238, 0, 0, 0, 23, 35, 296
"/home/unlv/Desktop/rsa306b_api_applications/stored_program/SRC/rsa_cpp/program_core/common_utility/cu_ifstream_acq_status.cpp", "C++", 60, 0, 0, 0, 19, 14, 93
"/home/unlv/Desktop/rsa306b_api_applications/stored_program/SRC/rsa_cpp/program_core/common_utility/cu_iqblk_acq_status.cpp", "C++", 72, 0, 0, 0, 19, 16, 107
"/home/unlv/Desktop/rsa306b_api_applications/stored_program/SRC/rsa_cpp/program_core/common_utility/cu_iqstream_acq_status.cpp", "C++", 120, 0, 0, 0, 18, 23, 161
"/home/unlv/Desktop/rsa306b_api_applications/stored_program/SRC/rsa_cpp/program_core/common_utility/cu_make_date_timestamp.cpp", "C++", 34, 0, 0, 0, 17, 13, 64
"/home/unlv/Desktop/rsa306b_api_applications/stored_program/SRC/rsa_cpp/program_core/common_utility/cu_spectrum_acq_status.cpp", "C++", 72, 0, 0, 0, 18, 15, 105
"/home/unlv/Desktop/rsa306b_api_applications/stored_program/SRC/rsa_cpp/program_core/common_utility/cu_timing.cpp", "C++", 286, 0, 0, 0, 109, 79, 474
"/home/unlv/Desktop/rsa306b_api_applications/stored_program/SRC/rsa_cpp/program_core/common_utility/cu_wchar_2_char.cpp", "C++", 96, 0, 0, 0, 24, 16, 136
"/home/unlv/Desktop/rsa306b_api_applications/stored_program/SRC/rsa_cpp/program_core/control/RSA_API.h", "C++", 782, 0, 0, 0, 175, 139, 1096
"/home/unlv/Desktop/rsa306b_api_applications/stored_program/SRC/rsa_cpp/program_core/control/codez.h", "C++", 77, 0, 0, 0, 9, 9, 95
"/home/unlv/Desktop/rsa306b_api_applications/stored_program/SRC/rsa_cpp/program_core/control/common_libraries.h", "C++", 23, 0, 0, 0, 7, 11, 41
"/home/unlv/Desktop/rsa306b_api_applications/stored_program/SRC/rsa_cpp/program_core/control/constant_expersions.h", "C++", 141, 0, 0, 0, 19, 23, 183
"/home/unlv/Desktop/rsa306b_api_applications/stored_program/SRC/rsa_cpp/program_core/control/de_bug/de_bug.cpp", "C++", 11, 0, 0, 0, 8, 9, 28
"/home/unlv/Desktop/rsa306b_api_applications/stored_program/SRC/rsa_cpp/program_core/control/de_bug/de_bug.h", "C++", 18, 0, 0, 0, 8, 12, 38
"/home/unlv/Desktop/rsa306b_api_applications/stored_program/SRC/rsa_cpp/program_core/control/de_bug/debug_functions.cpp", "C++", 120, 0, 0, 0, 38, 30, 188
"/home/unlv/Desktop/rsa306b_api_applications/stored_program/SRC/rsa_cpp/program_core/control/globalz.cpp", "C++", 5, 0, 0, 0, 8, 9, 22
"/home/unlv/Desktop/rsa306b_api_applications/stored_program/SRC/rsa_cpp/program_core/control/globalz.h", "C++", 11, 0, 0, 0, 6, 15, 32
"/home/unlv/Desktop/rsa306b_api_applications/stored_program/SRC/rsa_cpp/program_core/control/resourcez.h", "C++", 61, 0, 0, 0, 44, 35, 140
"/home/unlv/Desktop/rsa306b_api_applications/stored_program/SRC/rsa_cpp/program_core/main.cpp", "C++", 105, 0, 0, 0, 42, 18, 165
"/home/unlv/Desktop/rsa306b_api_applications/stored_program/SRC/rsa_cpp/program_core/r3f_manager/r3f_manager_class.h", "C++", 41, 0, 0, 0, 97, 26, 164
"/home/unlv/Desktop/rsa306b_api_applications/stored_program/SRC/rsa_cpp/program_core/r3f_manager/r3f_manager_struct.h", "C++", 86, 0, 0, 0, 30, 22, 138
"/home/unlv/Desktop/rsa306b_api_applications/stored_program/SRC/rsa_cpp/program_core/r3f_manager/r3fc_file_decode.cpp", "C++", 1, 0, 0, 0, 111, 10, 122
"/home/unlv/Desktop/rsa306b_api_applications/stored_program/SRC/rsa_cpp/program_core/r3f_manager/r3fc_file_process.cpp", "C++", 0, 0, 0, 0, 552, 45, 597
"/home/unlv/Desktop/rsa306b_api_applications/stored_program/SRC/rsa_cpp/program_core/r3f_manager/r3fc_handle_adc.cpp", "C++", 0, 0, 0, 0, 322, 34, 356
"/home/unlv/Desktop/rsa306b_api_applications/stored_program/SRC/rsa_cpp/program_core/r3f_manager/r3fc_plot_maker.cpp", "C++", 0, 0, 0, 0, 217, 24, 241
"/home/unlv/Desktop/rsa306b_api_applications/stored_program/SRC/rsa_cpp/program_core/r3f_manager/r3fc_private.cpp", "C++", 0, 0, 0, 0, 212, 30, 242
"/home/unlv/Desktop/rsa306b_api_applications/stored_program/SRC/rsa_cpp/program_core/r3f_manager/r3fc_public.cpp", "C++", 21, 0, 0, 0, 183, 43, 247
"/home/unlv/Desktop/rsa306b_api_applications/stored_program/SRC/rsa_cpp/program_core/rsa306b/rsa306b_ALIGN/rsa306b_align_copy.cpp", "C++", 34, 0, 0, 0, 23, 19, 76
"/home/unlv/Desktop/rsa306b_api_applications/stored_program/SRC/rsa_cpp/program_core/rsa306b/rsa306b_ALIGN/rsa306b_align_get.cpp", "C++", 61, 0, 0, 0, 23, 19, 103
"/home/unlv/Desktop/rsa306b_api_applications/stored_program/SRC/rsa_cpp/program_core/rsa306b/rsa306b_ALIGN/rsa306b_align_init.cpp", "C++", 11, 0, 0, 0, 14, 8, 33
"/home/unlv/Desktop/rsa306b_api_applications/stored_program/SRC/rsa_cpp/program_core/rsa306b/rsa306b_ALIGN/rsa306b_align_print.cpp", "C++", 12, 0, 0, 0, 15, 8, 35
"/home/unlv/Desktop/rsa306b_api_applications/stored_program/SRC/rsa_cpp/program_core/rsa306b/rsa306b_ALIGN/rsa306b_align_struct.h", "C++", 12, 0, 0, 0, 35, 23, 70
"/home/unlv/Desktop/rsa306b_api_applications/stored_program/SRC/rsa_cpp/program_core/rsa306b/rsa306b_ALIGN/rsa306b_align_user.cpp", "C++", 61, 0, 0, 0, 26, 18, 105
"/home/unlv/Desktop/rsa306b_api_applications/stored_program/SRC/rsa_cpp/program_core/rsa306b/rsa306b_AUDIO/rsa306b_audio_copy.cpp", "C++", 96, 0, 0, 0, 53, 49, 198
"/home/unlv/Desktop/rsa306b_api_applications/stored_program/SRC/rsa_cpp/program_core/rsa306b/rsa306b_AUDIO/rsa306b_audio_get.cpp", "C++", 141, 0, 0, 0, 38, 39, 218
"/home/unlv/Desktop/rsa306b_api_applications/stored_program/SRC/rsa_cpp/program_core/rsa306b/rsa306b_AUDIO/rsa306b_audio_init.cpp", "C++", 17, 0, 0, 0, 14, 9, 40
"/home/unlv/Desktop/rsa306b_api_applications/stored_program/SRC/rsa_cpp/program_core/rsa306b/rsa306b_AUDIO/rsa306b_audio_print.cpp", "C++", 27, 0, 0, 0, 14, 8, 49
"/home/unlv/Desktop/rsa306b_api_applications/stored_program/SRC/rsa_cpp/program_core/rsa306b/rsa306b_AUDIO/rsa306b_audio_set.cpp", "C++", 201, 0, 0, 0, 50, 40, 291
"/home/unlv/Desktop/rsa306b_api_applications/stored_program/SRC/rsa_cpp/program_core/rsa306b/rsa306b_AUDIO/rsa306b_audio_struct.h", "C++", 30, 0, 0, 0, 79, 34, 143
"/home/unlv/Desktop/rsa306b_api_applications/stored_program/SRC/rsa_cpp/program_core/rsa306b/rsa306b_AUDIO/rsa306b_audio_user.cpp", "C++", 102, 0, 0, 0, 51, 21, 174
"/home/unlv/Desktop/rsa306b_api_applications/stored_program/SRC/rsa_cpp/program_core/rsa306b/rsa306b_AUDIO/rsa306b_audio_write_csv.cpp", "C++", 63, 0, 0, 0, 18, 14, 95
"/home/unlv/Desktop/rsa306b_api_applications/stored_program/SRC/rsa_cpp/program_core/rsa306b/rsa306b_CONFIG/rsa306b_config_copy.cpp", "C++", 74, 0, 0, 0, 43, 39, 156
"/home/unlv/Desktop/rsa306b_api_applications/stored_program/SRC/rsa_cpp/program_core/rsa306b/rsa306b_CONFIG/rsa306b_config_get.cpp", "C++", 167, 0, 0, 0, 43, 40, 250
"/home/unlv/Desktop/rsa306b_api_applications/stored_program/SRC/rsa_cpp/program_core/rsa306b/rsa306b_CONFIG/rsa306b_config_init.cpp", "C++", 15, 0, 0, 0, 14, 8, 37
"/home/unlv/Desktop/rsa306b_api_applications/stored_program/SRC/rsa_cpp/program_core/rsa306b/rsa306b_CONFIG/rsa306b_config_print.cpp", "C++", 24, 0, 0, 0, 14, 7, 45
"/home/unlv/Desktop/rsa306b_api_applications/stored_program/SRC/rsa_cpp/program_core/rsa306b/rsa306b_CONFIG/rsa306b_config_set.cpp", "C++", 137, 0, 0, 0, 34, 31, 202
"/home/unlv/Desktop/rsa306b_api_applications/stored_program/SRC/rsa_cpp/program_core/rsa306b/rsa306b_CONFIG/rsa306b_config_struct.h", "C++", 24, 0, 0, 0, 78, 29, 131
"/home/unlv/Desktop/rsa306b_api_applications/stored_program/SRC/rsa_cpp/program_core/rsa306b/rsa306b_CONFIG/rsa306b_config_user.cpp", "C++", 24, 0, 0, 0, 13, 7, 44
"/home/unlv/Desktop/rsa306b_api_applications/stored_program/SRC/rsa_cpp/program_core/rsa306b/rsa306b_DEVICE/rsa306b_device_copy.cpp", "C++", 108, 0, 0, 0, 58, 55, 221
"/home/unlv/Desktop/rsa306b_api_applications/stored_program/SRC/rsa_cpp/program_core/rsa306b/rsa306b_DEVICE/rsa306b_device_get.cpp", "C++", 166, 0, 0, 0, 60, 36, 262
"/home/unlv/Desktop/rsa306b_api_applications/stored_program/SRC/rsa_cpp/program_core/rsa306b/rsa306b_DEVICE/rsa306b_device_init.cpp", "C++", 30, 0, 0, 0, 15, 12, 57
"/home/unlv/Desktop/rsa306b_api_applications/stored_program/SRC/rsa_cpp/program_core/rsa306b/rsa306b_DEVICE/rsa306b_device_print.cpp", "C++", 30, 0, 0, 0, 15, 8, 53
"/home/unlv/Desktop/rsa306b_api_applications/stored_program/SRC/rsa_cpp/program_core/rsa306b/rsa306b_DEVICE/rsa306b_device_struct.h", "C++", 24, 0, 0, 0, 119, 43, 186
"/home/unlv/Desktop/rsa306b_api_applications/stored_program/SRC/rsa_cpp/program_core/rsa306b/rsa306b_DEVICE/rsa306b_device_user_checker.cpp", "C++", 30, 0, 0, 0, 31, 17, 78
"/home/unlv/Desktop/rsa306b_api_applications/stored_program/SRC/rsa_cpp/program_core/rsa306b/rsa306b_DEVICE/rsa306b_device_user_connector.cpp", "C++", 107, 0, 0, 0, 25, 24, 156
"/home/unlv/Desktop/rsa306b_api_applications/stored_program/SRC/rsa_cpp/program_core/rsa306b/rsa306b_DEVICE/rsa306b_device_user_operator.cpp", "C++", 147, 0, 0, 0, 45, 29, 221
"/home/unlv/Desktop/rsa306b_api_applications/stored_program/SRC/rsa_cpp/program_core/rsa306b/rsa306b_DPX/rsa306b_dpx_struct.h", "C++", 147, 0, 0, 0, 258, 75, 480
"/home/unlv/Desktop/rsa306b_api_applications/stored_program/SRC/rsa_cpp/program_core/rsa306b/rsa306b_GP/rsa306b_class.cpp", "C++", 114, 0, 0, 0, 48, 42, 204
"/home/unlv/Desktop/rsa306b_api_applications/stored_program/SRC/rsa_cpp/program_core/rsa306b/rsa306b_GP/rsa306b_gp_confirm.cpp", "C++", 57, 0, 0, 0, 40, 27, 124
"/home/unlv/Desktop/rsa306b_api_applications/stored_program/SRC/rsa_cpp/program_core/rsa306b/rsa306b_GP/rsa306b_gp_print.cpp", "C++", 33, 0, 0, 0, 23, 16, 72
"/home/unlv/Desktop/rsa306b_api_applications/stored_program/SRC/rsa_cpp/program_core/rsa306b/rsa306b_IFSTREAM/rsa306b_ifstream_copy.cpp", "C++", 298, 0, 0, 0, 149, 146, 593
"/home/unlv/Desktop/rsa306b_api_applications/stored_program/SRC/rsa_cpp/program_core/rsa306b/rsa306b_IFSTREAM/rsa306b_ifstream_get.cpp", "C++", 189, 0, 0, 0, 38, 36, 263
"/home/unlv/Desktop/rsa306b_api_applications/stored_program/SRC/rsa_cpp/program_core/rsa306b/rsa306b_IFSTREAM/rsa306b_ifstream_init.cpp", "C++", 47, 0, 0, 0, 15, 18, 80
"/home/unlv/Desktop/rsa306b_api_applications/stored_program/SRC/rsa_cpp/program_core/rsa306b/rsa306b_IFSTREAM/rsa306b_ifstream_print.cpp", "C++", 54, 0, 0, 0, 13, 8, 75
"/home/unlv/Desktop/rsa306b_api_applications/stored_program/SRC/rsa_cpp/program_core/rsa306b/rsa306b_IFSTREAM/rsa306b_ifstream_set.cpp", "C++", 259, 0, 0, 0, 55, 50, 364
"/home/unlv/Desktop/rsa306b_api_applications/stored_program/SRC/rsa_cpp/program_core/rsa306b/rsa306b_IFSTREAM/rsa306b_ifstream_struct.h", "C++", 75, 0, 0, 0, 170, 57, 302
"/home/unlv/Desktop/rsa306b_api_applications/stored_program/SRC/rsa_cpp/program_core/rsa306b/rsa306b_IFSTREAM/rsa306b_ifstream_user_adc_data.cpp", "C++", 159, 0, 0, 0, 49, 34, 242
"/home/unlv/Desktop/rsa306b_api_applications/stored_program/SRC/rsa_cpp/program_core/rsa306b/rsa306b_IFSTREAM/rsa306b_ifstream_user_framed_adc_data.cpp", "C++", 123, 0, 0, 0, 41, 23, 187
"/home/unlv/Desktop/rsa306b_api_applications/stored_program/SRC/rsa_cpp/program_core/rsa306b/rsa306b_IFSTREAM/rsa306b_ifstream_user_record_r3f.cpp", "C++", 35, 0, 0, 0, 28, 10, 73
"/home/unlv/Desktop/rsa306b_api_applications/stored_program/SRC/rsa_cpp/program_core/rsa306b/rsa306b_IFSTREAM/rsa306b_ifstream_user_write_csv_equalization.cpp", "C++", 82, 0, 0, 0, 20, 14, 116
"/home/unlv/Desktop/rsa306b_api_applications/stored_program/SRC/rsa_cpp/program_core/rsa306b/rsa306b_IQBLK/rsa306b_iqblk_acquire.cpp", "C++", 180, 0, 0, 0, 29, 34, 243
"/home/unlv/Desktop/rsa306b_api_applications/stored_program/SRC/rsa_cpp/program_core/rsa306b/rsa306b_IQBLK/rsa306b_iqblk_copy.cpp", "C++", 136, 0, 0, 0, 67, 64, 267
"/home/unlv/Desktop/rsa306b_api_applications/stored_program/SRC/rsa_cpp/program_core/rsa306b/rsa306b_IQBLK/rsa306b_iqblk_get.cpp", "C++", 192, 0, 0, 0, 48, 44, 284
"/home/unlv/Desktop/rsa306b_api_applications/stored_program/SRC/rsa_cpp/program_core/rsa306b/rsa306b_IQBLK/rsa306b_iqblk_init.cpp", "C++", 31, 0, 0, 0, 13, 13, 57
"/home/unlv/Desktop/rsa306b_api_applications/stored_program/SRC/rsa_cpp/program_core/rsa306b/rsa306b_IQBLK/rsa306b_iqblk_print.cpp", "C++", 23, 0, 0, 0, 13, 8, 44
"/home/unlv/Desktop/rsa306b_api_applications/stored_program/SRC/rsa_cpp/program_core/rsa306b/rsa306b_IQBLK/rsa306b_iqblk_set.cpp", "C++", 138, 0, 0, 0, 35, 32, 205
"/home/unlv/Desktop/rsa306b_api_applications/stored_program/SRC/rsa_cpp/program_core/rsa306b/rsa306b_IQBLK/rsa306b_iqblk_struct.h", "C++", 41, 0, 0, 0, 130, 41, 212
"/home/unlv/Desktop/rsa306b_api_applications/stored_program/SRC/rsa_cpp/program_core/rsa306b/rsa306b_IQBLK/rsa306b_iqblk_user.cpp", "C++", 89, 0, 0, 0, 18, 20, 127
"/home/unlv/Desktop/rsa306b_api_applications/stored_program/SRC/rsa_cpp/program_core/rsa306b/rsa306b_IQSTREAM/rsa306b_iqstream_acquire.cpp", "C++", 182, 0, 0, 0, 50, 33, 265
"/home/unlv/Desktop/rsa306b_api_applications/stored_program/SRC/rsa_cpp/program_core/rsa306b/rsa306b_IQSTREAM/rsa306b_iqstream_copy.cpp", "C++", 231, 0, 0, 0, 110, 106, 447
"/home/unlv/Desktop/rsa306b_api_applications/stored_program/SRC/rsa_cpp/program_core/rsa306b/rsa306b_IQSTREAM/rsa306b_iqstream_get.cpp", "C++", 179, 0, 0, 0, 47, 39, 265
"/home/unlv/Desktop/rsa306b_api_applications/stored_program/SRC/rsa_cpp/program_core/rsa306b/rsa306b_IQSTREAM/rsa306b_iqstream_init.cpp", "C++", 53, 0, 0, 0, 18, 18, 89
"/home/unlv/Desktop/rsa306b_api_applications/stored_program/SRC/rsa_cpp/program_core/rsa306b/rsa306b_IQSTREAM/rsa306b_iqstream_print.cpp", "C++", 83, 0, 0, 0, 14, 12, 109
"/home/unlv/Desktop/rsa306b_api_applications/stored_program/SRC/rsa_cpp/program_core/rsa306b/rsa306b_IQSTREAM/rsa306b_iqstream_set.cpp", "C++", 322, 0, 0, 0, 56, 50, 428
"/home/unlv/Desktop/rsa306b_api_applications/stored_program/SRC/rsa_cpp/program_core/rsa306b/rsa306b_IQSTREAM/rsa306b_iqstream_struct.h", "C++", 68, 0, 0, 0, 218, 60, 346
"/home/unlv/Desktop/rsa306b_api_applications/stored_program/SRC/rsa_cpp/program_core/rsa306b/rsa306b_IQSTREAM/rsa306b_iqstream_user.cpp", "C++", 74, 0, 0, 0, 34, 26, 134
"/home/unlv/Desktop/rsa306b_api_applications/stored_program/SRC/rsa_cpp/program_core/rsa306b/rsa306b_IQSTREAM/rsa306b_iqstream_user_record_siq.cpp", "C++", 62, 0, 0, 0, 46, 11, 119
"/home/unlv/Desktop/rsa306b_api_applications/stored_program/SRC/rsa_cpp/program_core/rsa306b/rsa306b_IQSTREAM/rsa306b_iqstream_write_csv.cpp", "C++", 172, 0, 0, 0, 36, 28, 236
"/home/unlv/Desktop/rsa306b_api_applications/stored_program/SRC/rsa_cpp/program_core/rsa306b/rsa306b_PLAYBACK/rsa306b_playback_struct.h", "C++", 27, 0, 0, 0, 41, 26, 94
"/home/unlv/Desktop/rsa306b_api_applications/stored_program/SRC/rsa_cpp/program_core/rsa306b/rsa306b_REFTIME/rsa306b_reftime_copy.cpp", "C++", 90, 0, 0, 0, 48, 44, 182
"/home/unlv/Desktop/rsa306b_api_applications/stored_program/SRC/rsa_cpp/program_core/rsa306b/rsa306b_REFTIME/rsa306b_reftime_get.cpp", "C++", 160, 0, 0, 0, 42, 40, 242
"/home/unlv/Desktop/rsa306b_api_applications/stored_program/SRC/rsa_cpp/program_core/rsa306b/rsa306b_REFTIME/rsa306b_reftime_init.cpp", "C++", 23, 0, 0, 0, 14, 12, 49
"/home/unlv/Desktop/rsa306b_api_applications/stored_program/SRC/rsa_cpp/program_core/rsa306b/rsa306b_REFTIME/rsa306b_reftime_print.cpp", "C++", 31, 0, 0, 0, 13, 12, 56
"/home/unlv/Desktop/rsa306b_api_applications/stored_program/SRC/rsa_cpp/program_core/rsa306b/rsa306b_REFTIME/rsa306b_reftime_struct.h", "C++", 34, 0, 0, 0, 86, 32, 152
"/home/unlv/Desktop/rsa306b_api_applications/stored_program/SRC/rsa_cpp/program_core/rsa306b/rsa306b_REFTIME/rsa306b_reftime_user.cpp", "C++", 118, 0, 0, 0, 42, 25, 185
"/home/unlv/Desktop/rsa306b_api_applications/stored_program/SRC/rsa_cpp/program_core/rsa306b/rsa306b_SPECTRUM/rsa306b_spectrum_copy.cpp", "C++", 168, 0, 0, 0, 73, 73, 314
"/home/unlv/Desktop/rsa306b_api_applications/stored_program/SRC/rsa_cpp/program_core/rsa306b/rsa306b_SPECTRUM/rsa306b_spectrum_get.cpp", "C++", 148, 0, 0, 0, 38, 35, 221
"/home/unlv/Desktop/rsa306b_api_applications/stored_program/SRC/rsa_cpp/program_core/rsa306b/rsa306b_SPECTRUM/rsa306b_spectrum_helper.cpp", "C++", 113, 0, 0, 0, 29, 22, 164
"/home/unlv/Desktop/rsa306b_api_applications/stored_program/SRC/rsa_cpp/program_core/rsa306b/rsa306b_SPECTRUM/rsa306b_spectrum_init_default.cpp", "C++", 71, 0, 0, 0, 20, 23, 114
"/home/unlv/Desktop/rsa306b_api_applications/stored_program/SRC/rsa_cpp/program_core/rsa306b/rsa306b_SPECTRUM/rsa306b_spectrum_print.cpp", "C++", 73, 0, 0, 0, 16, 9, 98
"/home/unlv/Desktop/rsa306b_api_applications/stored_program/SRC/rsa_cpp/program_core/rsa306b/rsa306b_SPECTRUM/rsa306b_spectrum_scanner.cpp", "C++", 246, 0, 0, 0, 23, 28, 297
"/home/unlv/Desktop/rsa306b_api_applications/stored_program/SRC/rsa_cpp/program_core/rsa306b/rsa306b_SPECTRUM/rsa306b_spectrum_set.cpp", "C++", 222, 0, 0, 0, 32, 31, 285
"/home/unlv/Desktop/rsa306b_api_applications/stored_program/SRC/rsa_cpp/program_core/rsa306b/rsa306b_SPECTRUM/rsa306b_spectrum_struct.h", "C++", 75, 0, 0, 0, 127, 40, 242
"/home/unlv/Desktop/rsa306b_api_applications/stored_program/SRC/rsa_cpp/program_core/rsa306b/rsa306b_SPECTRUM/rsa306b_spectrum_user.cpp", "C++", 135, 0, 0, 0, 36, 24, 195
"/home/unlv/Desktop/rsa306b_api_applications/stored_program/SRC/rsa_cpp/program_core/rsa306b/rsa306b_TRIG/rsa306b_trig_copy.cpp", "C++", 76, 0, 0, 0, 43, 40, 159
"/home/unlv/Desktop/rsa306b_api_applications/stored_program/SRC/rsa_cpp/program_core/rsa306b/rsa306b_TRIG/rsa306b_trig_get.cpp", "C++", 169, 0, 0, 0, 43, 40, 252
"/home/unlv/Desktop/rsa306b_api_applications/stored_program/SRC/rsa_cpp/program_core/rsa306b/rsa306b_TRIG/rsa306b_trig_init.cpp", "C++", 17, 0, 0, 0, 13, 10, 40
"/home/unlv/Desktop/rsa306b_api_applications/stored_program/SRC/rsa_cpp/program_core/rsa306b/rsa306b_TRIG/rsa306b_trig_print.cpp", "C++", 38, 0, 0, 0, 13, 8, 59
"/home/unlv/Desktop/rsa306b_api_applications/stored_program/SRC/rsa_cpp/program_core/rsa306b/rsa306b_TRIG/rsa306b_trig_set.cpp", "C++", 244, 0, 0, 0, 49, 45, 338
"/home/unlv/Desktop/rsa306b_api_applications/stored_program/SRC/rsa_cpp/program_core/rsa306b/rsa306b_TRIG/rsa306b_trig_struct.h", "C++", 26, 0, 0, 0, 81, 30, 137
"/home/unlv/Desktop/rsa306b_api_applications/stored_program/SRC/rsa_cpp/program_core/rsa306b/rsa306b_TRIG/rsa306b_trig_user.cpp", "C++", 26, 0, 0, 0, 17, 9, 52
"/home/unlv/Desktop/rsa306b_api_applications/stored_program/SRC/rsa_cpp/program_core/rsa306b/rsa306b_class.h", "C++", 359, 0, 0, 0, 551, 44, 954
"/home/unlv/Desktop/rsa306b_api_applications/stored_program/SRC/rsa_cpp/program_core/rsa306b/rsa306b_constants.h", "C++", 0, 0, 0, 0, 6, 8, 14
"/home/unlv/Desktop/rsa306b_api_applications/stored_program/SRC/rsa_cpp/program_core/rsa306b/rsa306b_struct.h", "C++", 31, 0, 0, 0, 16, 22, 69
"/home/unlv/Desktop/rsa306b_api_applications/stored_program/SRC/rsa_cpp/program_core/siq_manager/siq_common.cpp", "C++", 23, 0, 0, 0, 242, 51, 316
"/home/unlv/Desktop/rsa306b_api_applications/stored_program/SRC/rsa_cpp/program_core/siq_manager/siq_decode.cpp", "C++", 0, 0, 0, 0, 163, 22, 185
"/home/unlv/Desktop/rsa306b_api_applications/stored_program/SRC/rsa_cpp/program_core/siq_manager/siq_error_codes.cpp", "C++", 1, 0, 0, 0, 75, 16, 92
"/home/unlv/Desktop/rsa306b_api_applications/stored_program/SRC/rsa_cpp/program_core/siq_manager/siq_init_copy.cpp", "C++", 0, 0, 0, 0, 235, 66, 301
"/home/unlv/Desktop/rsa306b_api_applications/stored_program/SRC/rsa_cpp/program_core/siq_manager/siq_loader.cpp", "C++", 0, 0, 0, 0, 1134, 28, 1162
"/home/unlv/Desktop/rsa306b_api_applications/stored_program/SRC/rsa_cpp/program_core/siq_manager/siq_manager_class.h", "C++", 41, 0, 0, 0, 52, 20, 113
"/home/unlv/Desktop/rsa306b_api_applications/stored_program/SRC/rsa_cpp/program_core/siq_manager/siq_manager_struct.h", "C++", 212, 0, 0, 0, 40, 42, 294
"/home/unlv/Desktop/rsa306b_api_applications/stored_program/SRC/rsa_cpp/program_core/siq_manager/siq_printer.cpp", "C++", 0, 0, 0, 0, 205, 21, 226
"/home/unlv/Desktop/rsa306b_api_applications/stored_program/SRC/rsa_cpp/program_core/siq_manager/siq_write_csv.cpp", "C++", 0, 0, 0, 0, 206, 24, 230
"/home/unlv/Desktop/rsa306b_api_applications/stored_program/SRC/rsa_cpp/program_test/tasks/task_999.cpp", "C++", 17, 0, 0, 0, 7, 13, 37
"/home/unlv/Desktop/rsa306b_api_applications/stored_program/SRC/rsa_cpp/program_test/test_selector.cpp", "C++", 31, 0, 0, 0, 5, 16, 52
"/home/unlv/Desktop/rsa306b_api_applications/stored_program/SRC/rsa_cpp/program_test/testz.h", "C++", 28, 0, 0, 0, 36, 19, 83
"/home/unlv/Desktop/rsa306b_api_applications/stored_program/SRC/rsa_cpp/program_test/wait_enter_clear.cpp", "C++", 22, 0, 0, 0, 7, 17, 46
"/home/unlv/Desktop/rsa306b_api_applications/stored_program/SRC/rsa_cpp/python_interface/python_interface.h", "C++", 48, 0, 0, 0, 9, 17, 74
"/home/unlv/Desktop/rsa306b_api_applications/stored_program/SRC/rsa_cpp/python_interface/rsa_config.cpp", "C++", 17, 0, 0, 0, 8, 11, 36
"/home/unlv/Desktop/rsa306b_api_applications/stored_program/SRC/rsa_cpp/python_interface/rsa_device.cpp", "C++", 38, 0, 0, 0, 22, 17, 77
"/home/unlv/Desktop/rsa306b_api_applications/stored_program/SRC/rsa_cpp/python_interface/rsa_gp.cpp", "C++", 18, 0, 0, 0, 10, 12, 40
"/home/unlv/Desktop/rsa306b_api_applications/stored_program/SRC/rsa_cpp/python_interface/rsa_iqblk.cpp", "C++", 29, 0, 0, 0, 13, 21, 63
"/home/unlv/Desktop/rsa306b_api_applications/stored_program/SRC/rsa_cpp/python_interface/rsa_spectrum.cpp", "C++", 79, 0, 0, 0, 20, 17, 116
"/home/unlv/Desktop/rsa306b_api_applications/stored_program/SRC/unlv_rsapy/__init__.py", "Python", 0, 35, 0, 0, 15, 21, 71
"/home/unlv/Desktop/rsa306b_api_applications/stored_program/SRC/unlv_rsapy/configuration.py", "Python", 0, 16, 0, 0, 7, 7, 30
"/home/unlv/Desktop/rsa306b_api_applications/stored_program/SRC/unlv_rsapy/funz/admin.py", "Python", 0, 34, 0, 0, 4, 15, 53
"/home/unlv/Desktop/rsa306b_api_applications/stored_program/SRC/unlv_rsapy/funz/plot_iqblk.py", "Python", 0, 35, 0, 0, 9, 8, 52
"/home/unlv/Desktop/rsa306b_api_applications/stored_program/SRC/unlv_rsapy/funz/plot_spectrum.py", "Python", 0, 31, 0, 0, 9, 8, 48
"/home/unlv/Desktop/rsa306b_api_applications/stored_program/SRC/unlv_rsapy/r3f_wrapper/r3fw.py", "Python", 0, 2, 0, 0, 4, 5, 11
"/home/unlv/Desktop/rsa306b_api_applications/stored_program/SRC/unlv_rsapy/rsa_wrapper/api_config.py", "Python", 0, 4, 0, 0, 5, 6, 15
"/home/unlv/Desktop/rsa306b_api_applications/stored_program/SRC/unlv_rsapy/rsa_wrapper/api_device.py", "Python", 0, 15, 0, 0, 5, 12, 32
"/home/unlv/Desktop/rsa306b_api_applications/stored_program/SRC/unlv_rsapy/rsa_wrapper/api_gp.py", "Python", 0, 11, 0, 0, 5, 7, 23
"/home/unlv/Desktop/rsa306b_api_applications/stored_program/SRC/unlv_rsapy/rsa_wrapper/api_iqblk.py", "Python", 0, 13, 0, 0, 5, 8, 26
"/home/unlv/Desktop/rsa306b_api_applications/stored_program/SRC/unlv_rsapy/rsa_wrapper/api_spectrum.py", "Python", 0, 35, 0, 0, 5, 13, 53
"/home/unlv/Desktop/rsa306b_api_applications/stored_program/SRC/unlv_rsapy/rsa_wrapper/f_iqblk.py", "Python", 0, 19, 0, 0, 4, 6, 29
"/home/unlv/Desktop/rsa306b_api_applications/stored_program/SRC/unlv_rsapy/rsa_wrapper/f_spectrum.py", "Python", 0, 54, 0, 0, 4, 9, 67
"/home/unlv/Desktop/rsa306b_api_applications/stored_program/SRC/unlv_rsapy/siq_wrapper/siqw.py", "Python", 0, 2, 0, 0, 4, 5, 11
"Total", "-", 12071, 646, 227, 17, 9868, 4322, 27151